load,windall,windallsigma,windnorth,windnorthsigma,windsouth,windsouthsigma
26418,7045,6893,5885,7026,1160,133
25825,6760,6453,5601,6590,1159,137
25267,6112,5581,5070,5605,1042,24
25055,5248,4402,4448,4434,800,32
24961,4538,3591,3826,3593,712,2
25373,4580,3155,3637,3517,943,362
26204,4759,3343,3453,3784,1306,441
26830,4733,3355,3170,4211,1563,856
27662,4053,1932,2425,2853,1628,921
28413,3415,894,1593,2219,1822,1424
28663,2672,850,1200,994,1472,1165
28623,2360,784,754,947,1606,1416
28460,1800,1069,493,374,1307,1443
28060,1345,826,322,97,1023,923
27564,1240,757,381,47,859,804
27319,1241,647,410,58,831,705
27454,1204,607,449,71,755,678
29219,1115,521,403,78,712,565
32078,1211,615,451,131,760,584
32503,1255,622,480,148,775,565
32463,1449,680,658,226,791,542
32189,2012,818,1017,804,995,713
31226,2307,850,1123,1255,1184,810
29928,2379,863,1185,1237,1194,784
28905,2244,879,1112,1036,1132,740
28543,2202,859,986,1005,1216,775
28556,2224,855,1027,1052,1197,814
28938,2076,826,1047,970,1029,705
29882,2234,860,1116,1231,1118,642
31768,2336,859,1285,1351,1051,594
34310,2441,1006,1384,1536,1057,530
35686,2265,840,1271,1290,994,509
35905,2144,856,1275,1156,869,467
35828,1495,803,748,531,747,385
35529,915,342,393,119,522,223
34582,748,304,228,74,520,230
33558,574,329,129,31,445,347
32415,344,181,81,8,263,173
31444,288,146,76,4,212,142
30965,268,149,92,2,176,147
31200,178,42,88,1,90,41
33423,127,13,86,1,41,12
36688,166,42,139,33,27,9
37376,284,77,260,76,24,1
37564,808,533,787,344,21,189
37057,1098,650,1034,499,64,222
35470,1798,816,1637,1050,161,253
33752,2694,1941,2449,2236,245,295
32795,3207,2150,2811,2260,396,110
32578,3913,2645,3408,2773,505,128
32821,4335,3171,3666,3291,669,120
33554,5039,4418,4244,4609,795,191
35225,5345,4820,4675,5000,670,180
38485,5393,4619,4659,4777,734,158
43081,4882,3876,4240,3946,642,70
44307,4721,3495,4114,3559,607,64
42620,4492,3174,3863,3199,629,25
40480,4067,2666,3507,2669,560,3
38574,3477,1989,2957,1990,520,1
36837,3546,2175,3022,2179,524,4
35333,3960,2859,3373,2860,587,1
34186,4220,3308,3554,3309,666,1
33210,4443,3258,3758,3261,685,3
32661,4868,3658,4049,3666,819,8
32799,5101,3944,4202,3968,899,24
34882,5261,4141,4345,4183,916,42
38077,6112,5318,4975,5414,1137,96
38568,6756,6404,5360,6574,1396,170
38442,7225,6891,5699,7297,1526,406
37342,7226,6663,5607,7144,1619,481
35066,7235,6616,5478,7140,1757,524
32696,7142,6403,5434,7010,1708,607
31266,6938,5844,5240,6494,1698,650
30672,6299,4441,4819,4960,1480,519
30499,5502,3723,4048,4211,1454,488
30644,4652,2921,3500,3412,1152,491
31761,4177,3501,3092,3947,1085,446
34505,4290,5163,3001,5625,1289,462
38800,4251,3656,3150,3956,1101,300
39882,4737,3259,3515,3570,1222,311
38362,5334,4099,4151,4290,1183,191
36789,5511,5136,4494,5283,1017,147
35356,5071,3878,4085,3902,986,24
34225,5227,3832,4101,3928,1126,96
33306,5225,3775,4013,3928,1212,153
32662,4913,3679,3848,3879,1065,200
32113,4184,2368,3229,2606,955,238
31554,4067,2211,3083,2457,984,246
31604,3378,1378,2527,1669,851,291
32953,2962,1343,2113,1738,849,395
35428,2359,891,1586,1120,773,374
35542,1997,884,1340,876,657,387
35232,1898,858,1196,1086,702,498
34151,1542,813,1058,1180,484,500
32134,1013,740,624,553,389,406
29962,752,590,267,292,485,298
28689,412,252,127,26,285,226
28212,321,214,129,52,192,162
28083,207,180,153,117,54,105
28387,298,292,288,423,10,131
29499,354,342,348,407,6,65
32356,441,413,382,414,59,1
36686,578,513,519,514,59,1
37984,791,818,763,819,28,1
36622,922,591,842,582,80,9
35400,966,389,907,388,59,1
34454,909,376,839,375,70,1
33552,744,182,657,181,87,1
32810,997,345,831,344,166,1
32333,1101,393,891,390,210,3
31850,1264,495,953,482,311,13
31527,1232,484,909,442,323,42
31463,1221,558,933,490,288,68
32555,1283,681,994,640,289,41
34771,1880,921,1563,1082,317,161
34781,3041,2192,2571,2352,470,160
34363,4096,3103,3460,3293,636,190
33084,4932,3807,4204,3996,728,189
30914,5772,4890,4952,5100,820,210
28721,6342,5521,5532,5782,810,261
27353,6379,5620,5604,5878,775,258
26545,6316,5541,5548,5744,768,203
26194,6174,5479,5410,5577,764,98
26317,6351,5784,5541,5888,810,104
27045,6412,5776,5548,5886,864,110
29266,6520,5863,5648,5983,872,120
33062,6213,5349,5368,5451,845,102
34422,6176,5670,5361,5768,815,98
33438,5642,5017,4920,5021,722,4
32935,5093,4593,4527,4594,566,1
32669,4246,3668,3758,3669,488,1
32230,3583,2293,3077,2294,506,1
31885,3907,2198,3197,2244,710,46
31848,4454,2652,3402,2756,1052,104
31730,4859,2995,3735,3218,1124,223
31483,4526,2874,3435,3132,1091,258
31162,3963,2634,2838,2924,1125,290
31517,3392,2173,2340,2561,1052,388
33059,2985,1185,2144,1623,841,438
32580,3467,1578,2593,2095,874,517
31764,5033,3358,4028,4053,1005,695
30746,5114,2878,4245,3443,869,565
29348,5761,3653,4686,4206,1075,553
27507,6223,4427,4957,5035,1266,608
26158,6093,4497,4884,5039,1209,542
25186,6023,4624,4827,5121,1196,497
24599,5606,4112,4437,4500,1169,388
24468,5258,3607,4142,3965,1116,358
24726,4925,3195,3834,3481,1091,286
25617,4883,3506,3722,3795,1161,289
27134,4209,2492,3214,2766,995,274
28475,4038,2621,3160,2911,878,290
29773,3352,2476,2636,2641,716,165
31007,2679,2716,2075,2849,604,133
31581,1580,1277,1199,1317,381,40
31626,895,774,540,793,355,19
31322,386,73,207,72,179,1
30798,231,5,127,4,104,1
30432,180,5,87,4,93,1
30297,153,7,35,6,118,1
30231,164,15,7,6,157,9
31088,213,23,14,4,199,19
32814,470,309,79,16,391,293
32718,623,357,196,38,427,319
32110,929,574,582,172,347,402
31207,1062,549,856,292,206,257
29920,1378,659,1076,435,302,224
28414,1699,801,1255,714,444,270
27048,1809,836,1398,849,411,353
26231,1794,786,1309,1075,485,363
25773,1732,828,1245,970,487,261
25682,1899,1021,1522,1300,377,279
25883,1850,931,1546,1108,304,177
26537,2096,1474,1773,1643,323,169
27663,1862,1480,1563,1591,299,111
28744,1786,1322,1548,1417,238,95
29797,1809,1241,1541,1242,268,1
30822,1232,421,943,419,289,2
31119,1114,289,689,268,425,21
31101,1297,456,683,341,614,115
31150,1438,508,738,260,700,248
30972,1771,776,949,416,822,374
30678,2194,824,1295,516,899,555
30623,2592,860,1622,815,970,593
30997,2671,859,1828,798,843,540
32500,2986,868,2226,1041,760,519
34417,3737,1428,2882,1947,855,519
34412,4313,2110,3347,2614,966,504
33731,5204,3292,4179,3829,1025,537
32395,5752,4563,4738,5115,1014,552
30429,5751,4324,4754,4775,997,451
28255,5807,4264,4703,4627,1104,363
26683,6087,4956,4968,5235,1119,279
26031,5908,4605,4859,4837,1049,232
25930,5765,4364,4620,4532,1145,168
26115,5874,4608,4669,4754,1205,146
26929,5493,3993,4372,4142,1121,149
29378,5797,4643,4787,4827,1010,184
33465,5208,3800,4360,3942,848,142
35288,5470,4239,4540,4347,930,108
35361,5299,4042,4354,4207,945,165
35904,5493,5590,4434,5881,1059,291
36290,4627,4794,3762,5033,865,239
36928,4262,4252,3116,4525,1146,273
37050,3563,2087,2495,2285,1068,198
37073,3956,2562,2640,2938,1316,376
36759,4164,2745,2802,3396,1362,651
36427,3818,1936,2470,2430,1348,494
36687,3935,2255,2501,2863,1434,608
38193,2626,860,1675,1134,951,373
39775,2543,767,1512,1159,1031,413
39340,2655,855,1634,1044,1021,511
38406,2715,861,1615,1135,1100,373
36757,3224,1132,1937,1763,1287,631
33925,3279,1763,1884,2772,1395,1009
31581,2504,865,1298,1528,1206,866
29974,2824,1190,1606,2087,1218,897
29192,3117,1813,1810,2652,1307,839
28997,3407,1506,1985,2580,1422,1074
29190,3014,980,1837,1725,1177,745
30381,3294,1204,2145,1863,1149,659
33220,3685,1538,2559,2195,1126,657
37659,3634,1437,2702,1961,932,524
39438,3677,1546,2663,2044,1014,498
38587,3522,1550,2459,2092,1063,542
38309,3270,1353,2213,1863,1057,510
38367,2581,850,1625,976,956,378
37950,2541,858,1549,998,992,400
37251,2763,915,1654,1320,1109,520
36790,2711,915,1567,1268,1144,537
36322,2818,912,1585,1504,1233,842
36006,2457,902,1375,1152,1082,688
36027,2043,886,1286,819,757,435
37361,1561,741,1205,513,356,228
39764,1537,545,1322,482,215,63
39797,1950,787,1722,749,228,38
39247,2883,1560,2438,1661,445,101
37783,3687,2535,3086,2718,601,183
35162,4225,2883,3671,3238,554,355
32875,4556,3229,3912,3560,644,331
31530,5086,4037,4324,4363,762,326
30924,5328,4178,4490,4590,838,412
30921,5908,5317,4916,5841,992,524
31407,5694,4813,4771,5380,923,567
32644,5711,4914,4798,5485,913,571
35711,5690,4873,4761,5450,929,577
40530,5679,4612,4843,5074,836,462
41539,5773,4601,4816,5016,957,415
39455,5405,4337,4504,4494,901,157
37248,5370,4859,4735,4961,635,102
35803,5233,4597,4513,4621,720,24
34554,5300,4572,4405,4590,895,18
33330,5595,5035,4555,5077,1040,42
32717,6059,5789,5012,5877,1047,88
32208,6195,5840,5143,5917,1052,77
31952,6368,6064,5267,6140,1101,76
32034,6112,5395,4985,5484,1127,89
32967,6223,5336,5129,5442,1094,106
35422,6895,6146,5654,6369,1241,223
35687,7032,6095,5609,6390,1423,295
35649,7412,6440,5869,6919,1543,479
34747,7496,6376,5804,6928,1692,552
32717,7283,6063,5677,6556,1606,493
30581,7176,5796,5605,6380,1571,584
29783,6678,4639,5292,5147,1386,508
29890,6690,4102,5284,4954,1406,852
30334,6663,4070,5319,4909,1344,839
31008,6433,3844,4880,4658,1553,814
32767,6089,3521,4419,4393,1670,872
36419,5666,3265,4001,4255,1665,990
41553,5035,2698,3318,3859,1717,1161
43393,4263,1825,2542,3056,1721,1231
42250,3515,840,1886,1968,1629,1235
41858,3149,846,1666,1258,1483,922
41653,3222,838,1829,1390,1393,852
40779,3212,987,1717,1710,1495,723
39923,2991,817,1581,1584,1410,828
39139,2735,818,1517,1378,1218,659
38467,2503,785,1328,1249,1175,679
38342,1976,752,1004,745,972,520
39412,1498,740,712,406,786,369
41122,1222,723,644,362,578,368
44259,914,239,652,125,262,114
44677,1179,406,922,357,257,49
44718,1802,981,1338,1034,464,53
43621,1997,1060,1553,1163,444,103
41565,2250,1384,1872,1520,378,136
39376,2435,1603,2034,1799,401,196
38091,2248,1426,1889,1523,359,97
37594,2251,1360,1972,1460,279,100
37433,2437,1961,2020,2025,417,64
37678,2370,1814,1963,1914,407,100
38748,2713,3022,2192,3182,521,160
41612,2489,3016,1887,3133,602,117
46007,2073,2247,1587,2533,486,286
46989,1748,1211,1368,1430,380,219
44927,1499,839,1210,1020,289,181
42663,842,273,706,238,136,35
40723,600,95,493,94,107,1
38414,607,90,502,85,105,5
36595,1037,206,874,205,163,1
34988,1628,642,1363,641,265,1
33666,1990,1146,1727,1147,263,1
33116,1872,1069,1605,1070,267,1
33181,1741,1373,1456,1374,285,1
34285,1323,967,1128,968,195,1
37450,1329,763,1108,751,221,12
38140,1929,1539,1673,1604,256,65
38313,2395,1907,2119,2007,276,100
38284,2631,1768,2285,1847,346,79
36763,3052,2010,2675,2065,377,55
35401,3774,2732,3359,2789,415,57
34456,4483,3502,4026,3551,457,49
34022,5002,4395,4513,4430,489,35
33989,5295,5051,4788,5069,507,18
34281,5042,4438,4504,4451,538,13
35132,5037,4537,4523,4542,514,5
36631,4802,4661,4368,4662,434,1
38452,4433,4688,4024,4690,409,2
39989,4107,4568,3719,4572,388,4
40056,3515,3308,3085,3309,430,1
38578,2473,2040,2201,2041,272,1
36720,1380,815,1250,816,130,1
34587,851,350,770,349,81,1
32548,704,214,639,213,65,1
30967,593,80,533,79,60,1
29825,702,190,600,189,102,1
29205,743,185,606,184,137,1
29026,738,139,564,138,174,1
30091,836,164,593,163,243,1
32663,1223,351,953,332,270,19
33078,2146,1043,1755,1088,391,45
33269,3074,1860,2503,1928,571,68
33090,4187,2991,3522,3081,665,90
32118,5274,4154,4536,4276,738,122
31085,5821,5077,4982,5203,839,126
30444,6040,5119,5226,5233,814,114
30144,5931,4929,5134,5031,797,102
30198,5913,4961,5100,5058,813,97
30508,6016,5167,5211,5269,805,102
31079,5864,5052,5030,5166,834,114
32124,5980,5403,5082,5536,898,133
33577,5418,4386,4727,4495,691,109
34725,5158,3850,4475,3947,683,97
35443,4877,3287,4186,3340,691,53
34796,4498,2762,3822,2809,676,47
33384,4161,2246,3418,2294,743,48
31921,4241,2128,3363,2245,878,117
30961,5082,2805,3974,3075,1108,270
30190,5477,3176,4322,3539,1155,363
29461,5933,3765,4682,4183,1251,418
29235,5887,3579,4625,4041,1262,462
29542,5711,3334,4401,3819,1310,485
30613,5534,3234,4242,3789,1292,555
32521,6373,4260,5005,4961,1368,701
32369,7297,5819,5711,6704,1586,885
31645,7812,6801,6018,7747,1794,946
30567,7794,6505,6158,7385,1636,880
28970,7769,6219,6101,7023,1668,804
26988,7752,6291,6097,7111,1655,820
25536,7665,6375,6076,7182,1589,807
24756,7416,6048,5907,6769,1509,721
24476,7072,5594,5652,6193,1420,599
24333,6988,5626,5653,6221,1335,595
24936,6804,5377,5415,5893,1389,516
26489,6820,5195,5455,5749,1365,554
28633,6974,5105,5465,5765,1509,660
29763,7087,5457,5460,6249,1627,792
30509,7089,5095,5550,5932,1539,837
31663,7041,5179,5441,6055,1600,876
32900,6821,4747,5153,5567,1668,820
33222,6737,4684,5114,5547,1623,863
33204,6923,5179,5298,6057,1625,878
33165,6861,4889,5139,5693,1722,804
32926,7162,5239,5265,6169,1897,930
32640,7168,5432,5127,6529,2041,1097
32793,6123,4090,4282,5248,1841,1158
33447,5814,4183,4006,5488,1808,1305
35115,5149,2726,3614,3744,1535,1018
34924,5575,3007,4046,3961,1529,954
34108,6044,3408,4610,4363,1434,955
32778,6441,4084,4875,5023,1566,939
30118,6724,4383,5010,5333,1714,950
27531,6919,4538,5217,5492,1702,954
25705,6696,4580,5052,5504,1644,924
24655,6341,4751,4732,5654,1609,903
24074,5872,4982,4249,5771,1623,789
23984,5063,3943,3782,4580,1281,637
24508,4465,2616,3471,3035,994,419
26624,4796,2759,3699,3093,1097,334
30437,5199,2923,4019,3374,1180,451
32275,5244,2967,3898,3358,1346,391
32284,6343,4549,4813,5057,1530,508
32830,6046,4128,4699,4629,1347,501
33619,5039,3075,3873,3425,1166,350
33866,3931,2491,2956,2594,975,103
33825,3161,2196,2502,2292,659,96
34022,2516,1940,1984,2047,532,107
33745,1779,1077,1455,1138,324,61
33615,1501,827,1241,892,260,65
33745,1198,522,940,454,258,68
34585,1155,449,928,341,227,108
37109,1595,863,1340,652,255,211
37220,2359,905,1890,1095,469,378
36767,3172,1270,2436,1786,736,516
35556,3718,1716,2776,2654,942,938
33159,3157,923,2228,1771,929,848
31083,2919,913,1803,1390,1116,814
29975,2353,895,1338,655,1015,851
29680,2140,876,1181,479,959,833
29760,2013,856,1004,433,1009,849
30343,1746,733,862,322,884,811
31743,1628,765,916,278,712,575
34996,1491,658,989,299,502,359
40055,1753,814,1276,531,477,362
41702,2013,870,1499,881,514,281
40107,2321,916,1876,1219,445,303
38422,2283,996,1852,1133,431,137
37289,2338,1096,1914,1146,424,50
35803,2697,1813,2269,1822,428,9
34354,2324,1500,2071,1501,253,1
33325,1994,901,1784,902,210,1
32469,2269,1070,2040,1071,229,1
31928,2848,1826,2530,1827,318,1
32529,2600,1542,2280,1543,320,1
33253,2501,1843,2263,1844,238,1
36272,2380,1527,2193,1528,187,1
36541,2847,1845,2600,1846,247,1
36367,3547,2403,3247,2445,300,42
35341,4275,2970,3837,3030,438,60
32905,5000,3968,4376,4035,624,67
30751,5755,5073,5106,5147,649,74
29608,6189,5550,5403,5637,786,87
29000,6394,5869,5607,5963,787,94
28718,6645,6475,5916,6594,729,119
28797,6419,6089,5697,6207,722,118
29647,6269,5743,5588,5845,681,102
32073,6102,6082,5479,6196,623,114
35936,5667,5238,5084,5328,583,90
37031,5571,5101,5042,5193,529,92
35445,5059,4536,4623,4578,436,42
34220,4157,4086,3661,4087,496,1
33496,3230,2908,2714,2909,516,1
32732,2524,1786,2171,1797,353,11
32179,2057,1074,1780,1094,277,20
32024,1879,1180,1591,1257,288,77
31911,1317,735,979,786,338,51
31865,1046,512,688,431,358,81
32295,923,349,525,221,398,128
32290,1043,424,609,199,434,225
34389,1537,781,1099,463,438,318
34408,2230,860,1713,1129,517,488
33749,2798,1117,2244,1634,554,517
32347,2822,992,2298,1457,524,465
30131,3485,1510,2760,2057,725,547
27765,3905,1804,3003,2329,902,525
26341,4825,3015,3882,3686,943,671
25633,4652,3048,3813,3695,839,647
25288,5122,3802,4228,4409,894,607
25476,5214,3321,4209,3843,1005,522
26266,5772,3879,4705,4440,1067,561
28520,6014,4142,4889,4715,1125,573
32318,6108,4555,4901,5087,1207,532
33874,6119,4569,5052,5035,1067,466
33235,5849,4300,4926,4737,923,437
33100,5400,4128,4404,4542,996,414
33418,4732,3221,3809,3637,923,416
33046,4281,2376,3457,2765,824,389
33062,4380,2244,3449,2578,931,334
33161,4370,2646,3371,3054,999,408
33137,4036,2182,3047,2698,989,516
33036,4023,1729,3040,2360,983,631
32879,4200,2038,3030,2825,1170,787
32817,4172,2222,2985,3076,1187,854
34225,4104,1981,3063,2711,1041,730
33699,4456,2596,3472,3388,984,792
32879,4817,2775,3757,3392,1060,617
31788,5479,3330,4210,3882,1269,552
30181,5847,4111,4558,4611,1289,500
28391,5986,4471,4758,4866,1228,395
26834,5716,4486,4626,4776,1090,290
26084,5122,3610,4195,3858,927,248
25586,4812,3808,3923,3994,889,186
25661,4164,2879,3358,3094,806,215
26074,3735,2279,3030,2454,705,175
27075,3732,2612,2942,2730,790,118
28946,3042,2184,2435,2206,607,22
30889,2259,1410,1719,1422,540,12
32590,1678,1140,1295,1153,383,13
33691,1013,622,737,654,276,32
34057,604,966,469,1063,135,97
33543,192,17,152,5,40,12
32761,182,16,130,15,52,1
31705,228,27,168,26,60,1
31029,306,53,272,38,34,15
30498,526,104,469,102,57,2
30329,993,379,893,374,100,5
31206,1409,573,1237,571,172,2
33599,2697,1412,2401,1438,296,26
33779,4754,3610,4220,3682,534,72
33501,6329,6075,5490,6197,839,122
32745,7089,7491,6058,7690,1031,199
31391,7417,7904,6331,8128,1086,224
29764,7434,7355,6390,7631,1044,276
28371,7584,7654,6465,7983,1119,329
27473,7542,7528,6447,7900,1095,372
26986,7752,7543,6497,8044,1255,501
26727,7868,7795,6552,8301,1316,506
26792,7866,7787,6438,8234,1428,447
27178,7927,7825,6499,8319,1428,494
27996,7962,7621,6432,8126,1530,505
28851,7936,7646,6482,8090,1454,444
29821,7902,7368,6428,7901,1474,533
30816,7943,7712,6405,8198,1538,486
31020,7799,7782,6046,8159,1753,377
30932,8030,7633,6146,8044,1884,411
30843,8254,7876,6460,8479,1794,603
30806,8231,8068,6826,8685,1405,617
30793,7997,7858,6683,8322,1314,464
30825,7766,7804,6495,8073,1271,269
31128,7277,7082,6226,7318,1051,236
31444,6545,6973,5602,7189,943,216
33576,4945,6707,4211,6942,734,235
33640,3467,3650,2968,3854,499,204
32796,2895,2810,2364,3006,531,196
31584,2777,3086,2106,3376,671,290
29724,2355,2316,1677,2516,678,200
27378,2174,1652,1554,1726,620,74
25777,1932,1156,1518,1167,414,11
24988,1934,1026,1524,1084,410,58
24749,1766,793,1412,859,354,131
24994,1745,836,1385,1155,360,319
25990,1609,839,1245,1160,364,709
28610,1361,775,844,472,517,712
33069,1053,628,685,241,368,451
34562,942,416,713,118,229,298
33733,881,376,671,148,210,228
33560,878,410,592,184,286,226
33470,723,188,562,58,161,130
33009,1025,296,849,156,176,140
32451,1220,464,975,330,245,134
32094,1162,435,884,325,278,110
31672,1074,474,844,314,230,160
31385,956,261,775,143,181,118
31496,1158,320,985,211,173,109
31982,1576,687,1368,576,208,111
34515,2104,907,1841,917,263,98
34890,3129,1486,2664,1612,465,126
34519,4644,3207,4026,3367,618,160
33436,5310,4089,4504,4190,806,101
31262,6197,5595,5289,5722,908,127
29117,6452,5713,5593,5857,859,144
27718,6085,5121,5248,5224,837,103
27098,6036,4861,5174,4981,862,120
26895,6206,5331,5318,5384,888,53
27086,6374,5758,5559,5825,815,67
27937,6111,5239,5322,5286,789,47
30374,5813,4436,4947,4516,866,80
34390,4771,3140,4009,3242,762,102
35577,4555,3050,3711,3203,844,153
34517,3935,2443,3023,2577,912,134
34082,3486,1830,2651,1968,835,138
33859,3286,1314,2463,1507,823,193
33577,3531,1473,2505,1819,1026,346
33298,4113,1560,2890,2271,1223,711
32988,4262,1724,2821,2588,1441,864
32764,4505,1960,2845,3071,1660,1111
32903,3936,1414,2311,2556,1625,1142
33656,3740,1374,1903,2956,1837,1582
34677,3036,916,1273,1993,1763,1499
36003,2384,860,1013,876,1371,1168
35827,2298,851,1204,774,1094,965
34993,2261,796,1171,785,1090,887
33466,2259,706,1228,845,1031,1043
31067,2457,805,1490,853,967,894
28571,2891,877,1932,1009,959,731
26946,3797,924,2562,1673,1235,806
26161,4851,1744,3716,2644,1135,900
25753,5199,2358,4048,3212,1151,854
25820,5776,2875,4494,3699,1282,824
26528,6596,4145,5208,5029,1388,884
28860,6631,4211,5419,5032,1212,821
32680,6666,4458,5226,5233,1440,775
34435,6943,5050,5335,5937,1608,887
34232,7191,5547,5931,6786,1260,1239
34553,6460,5859,5504,6769,956,910
35114,5845,5207,4900,5840,945,633
35149,5711,4242,4600,4668,1111,426
34947,5795,3659,4515,4144,1280,485
34646,6388,4394,4856,4987,1532,593
34430,6270,4192,4599,4904,1671,712
34538,5605,3815,3933,4533,1672,718
35001,4695,3727,2960,4462,1735,735
35900,3410,2854,1735,3397,1675,543
37465,2180,857,1038,1278,1142,456
37189,1972,857,907,892,1065,505
36406,1614,714,712,503,902,537
34787,1764,814,862,703,902,772
32334,2058,887,1283,1547,775,1213
29720,2010,891,1689,1409,321,716
28137,2399,1291,1990,1567,409,276
27362,3037,1698,2368,2010,669,312
27140,3812,3004,2929,3451,883,447
27346,3966,2679,3024,3076,942,397
28274,4048,2190,3059,2631,989,441
30841,4458,2868,3079,3338,1379,470
35281,4388,2782,3202,3374,1186,592
36702,4411,3579,3552,4240,859,661
35719,3886,2883,3255,3153,631,270
35074,3881,2732,3111,2903,770,171
34451,4411,3874,3463,4123,948,249
33707,3995,3045,3231,3260,764,215
32893,3466,1771,2700,1936,766,165
32468,3771,1950,2745,2135,1026,185
31841,3683,1850,2565,2216,1118,366
31503,2949,1499,1880,1812,1069,313
31948,2068,955,1170,1240,898,285
31925,1220,677,472,817,748,195
34386,657,319,283,203,374,116
35024,356,31,252,23,104,8
34932,364,56,333,55,31,1
34001,569,238,557,237,12,1
32024,1184,639,1160,640,24,1
29928,2236,1570,2143,1571,93,1
28698,3700,3336,3497,3370,203,34
28401,4691,3811,4359,3888,332,77
28577,5438,4480,4882,4481,556,1
29169,6389,6032,5559,6041,830,9
30391,6791,6535,5827,6579,964,44
33384,7058,7515,6085,7599,973,84
37978,6446,6336,5681,6373,765,37
39318,6391,6033,5511,6068,880,35
37526,6162,5811,5305,5812,857,1
35858,5360,4501,4689,4502,671,1
34709,4843,3378,3972,3379,871,1
33862,4560,2736,3541,2780,1019,44
32697,5133,3261,3804,3429,1329,168
32197,4675,2777,3377,3017,1298,240
31482,3715,1723,2596,1978,1119,255
31137,3685,1953,2513,2307,1172,354
30898,3686,2075,2525,2452,1161,377
30995,4343,2973,3078,3399,1265,426
32869,5441,3757,4069,4275,1372,518
32957,6200,4285,4617,4834,1583,549
32543,7675,6640,5759,7438,1916,798
31805,7741,7117,6004,7852,1737,735
30422,7890,7548,6333,8124,1557,576
28874,7716,7266,6259,7670,1457,404
27397,7478,6856,6142,7219,1336,363
26870,7231,6586,5950,6836,1281,250
26704,7021,6306,5821,6580,1200,274
26816,6550,5597,5417,5805,1133,208
27297,6154,6250,4935,6492,1219,242
28529,5817,4792,4572,5117,1245,325
30262,4968,4308,3719,4710,1249,402
31863,4024,3066,2797,3606,1227,540
33287,3409,2393,1963,3151,1446,758
34038,2675,900,1262,1625,1413,899
33980,2264,848,1201,788,1063,740
33219,2151,800,968,934,1183,974
32109,1481,704,464,335,1017,1014
31056,1062,905,308,35,754,940
30110,895,837,270,13,625,850
29639,900,825,303,10,597,835
29654,823,791,210,2,613,793
30604,824,668,202,6,622,674
33245,839,520,303,43,536,563
33937,931,480,349,89,582,478
34015,1209,628,536,244,673,612
33675,1535,747,858,588,677,809
32766,1777,845,985,866,792,661
31712,1783,787,1049,958,734,811
30790,1743,826,1181,927,562,689
30372,1995,893,1556,1184,439,472
30324,1950,885,1555,829,395,210
30571,2664,1844,2139,2179,525,335
31077,2796,1648,2312,1941,484,293
32181,3316,2110,2624,2392,692,282
33684,3242,1717,2586,2017,656,300
34990,3512,2030,2825,2286,687,256
35454,3324,2125,2770,2277,554,152
34526,2508,1557,2081,1616,427,59
33097,1699,697,1399,671,300,26
31637,1600,557,1334,528,266,29
30469,1788,782,1439,756,349,26
29398,1759,717,1415,666,344,51
28518,1837,738,1475,659,362,79
28058,2154,871,1718,893,436,78
28135,2273,910,1857,962,416,76
29251,2265,913,1916,990,349,79
32429,2745,1445,2338,1517,407,72
33467,3439,2008,2999,2056,440,48
33535,5007,4135,4323,4255,684,120
32852,5816,5461,4891,5600,925,139
31135,6372,6061,5432,6183,940,122
29157,6655,6271,5716,6396,939,125
27995,6633,6156,5683,6230,950,74
27689,6602,6151,5737,6235,865,84
27646,6348,5873,5599,5915,749,42
28024,6384,6029,5687,6067,697,38
29324,6230,5649,5566,5692,664,43
32178,6081,5647,5381,5695,700,48
36513,5649,4772,4879,4820,770,48
37700,5746,4807,4929,4848,817,41
36251,5248,4011,4515,4031,733,20
35247,5067,3846,4436,3862,631,16
34410,4595,3145,3932,3155,663,10
33549,4484,2848,3702,2870,782,22
32702,4607,2831,3783,2961,824,130
32232,4634,2880,3815,3008,819,128
31718,4834,3151,3989,3274,845,123
31556,4905,3150,3978,3295,927,145
32045,4859,3050,3946,3216,913,166
32810,4806,3072,4004,3233,802,161
34697,5555,4306,4697,4472,858,166
34736,6319,5644,5264,5802,1055,158
33946,7269,7136,5887,7463,1382,327
32500,7558,8033,6283,8401,1275,368
30108,7566,7920,6424,8168,1142,248
27533,7534,7757,6374,7919,1160,162
25954,7208,7289,6104,7386,1104,97
25087,6982,6898,5921,6967,1061,69
24776,7027,7112,6019,7160,1008,48
24775,6710,6509,5834,6531,876,22
25403,6284,5747,5540,5765,744,18
27418,5732,4707,5078,4729,654,22
30718,5613,4788,4972,4834,641,46
32200,4804,3940,4223,3989,581,49
31386,4267,3771,3642,3808,625,37
31495,3525,2780,2990,2799,535,19
31702,3155,2802,2714,2813,441,11
31689,2262,1731,1865,1735,397,4
31525,1870,1313,1476,1328,394,15
31665,1547,960,1108,1015,439,55
31617,1449,931,993,967,456,36
31573,1282,827,891,810,391,32
31580,820,176,504,155,316,21
31820,710,129,367,95,343,34
33659,814,216,491,139,323,77
33906,1135,305,774,258,361,47
33156,2030,950,1560,1039,470,89
31734,2863,1811,2385,1947,478,136
29253,3299,2274,2792,2431,507,157
26712,3410,2674,2810,2847,600,173
25059,2903,1985,2439,2112,464,127
24114,2893,2865,2323,2985,570,120
23669,2564,3487,1992,3620,572,133
23681,1789,1356,1384,1422,405,66
24233,1829,900,1489,925,340,25
26392,2459,1725,1953,1760,506,35
30279,2460,1843,1883,1937,577,94
31866,2564,2382,2024,2447,540,65
31459,2358,2495,1986,2514,372,19
31693,1681,1275,1514,1276,167,1
32144,1187,501,1029,499,158,2
32321,1198,514,1010,513,188,1
32474,1152,546,991,545,161,1
32767,926,383,824,382,102,1
33051,647,121,555,120,92,1
33256,748,183,619,182,129,1
33342,687,203,530,193,157,10
33222,602,178,362,145,240,33
34733,929,499,439,416,490,83
34894,1228,803,562,798,666,233
34020,1926,1460,1189,1787,737,327
32446,1930,1223,1312,1514,618,291
29909,2317,1913,1751,2203,566,290
27273,2631,2299,2199,2490,432,191
25419,2739,2282,2417,2338,322,56
24478,2979,2585,2748,2638,231,53
24090,3448,3445,3238,3496,210,51
24109,3203,2772,2999,2798,204,26
24791,3349,2778,3123,2803,226,25
27100,3593,3070,3267,3096,326,26
31208,2787,1470,2497,1524,290,54
32701,3001,1752,2623,1820,378,68
32283,2376,929,2064,976,312,47
32605,2413,1027,2063,1071,350,44
32980,2375,888,1995,959,380,71
32887,2694,851,2197,953,497,130
32645,4117,2017,3317,2306,800,289
32803,4603,2380,3716,2742,887,362
32674,4913,2528,3892,2977,1021,449
32631,5448,3317,4323,3824,1125,507
32988,5718,3828,4425,4267,1293,439
33337,5873,3935,4578,4486,1295,551
34695,6346,4952,5162,5526,1184,574
34571,6791,5677,5487,6256,1304,579
33923,7243,6386,5607,6961,1636,575
32440,7386,6625,5754,7262,1632,637
30048,7266,6073,5740,6609,1526,536
27514,7374,6190,5779,6698,1595,508
25755,7680,6685,6036,7276,1644,591
24769,7469,6294,5813,6863,1656,569
24252,7517,6537,5884,7110,1633,573
24461,7156,6093,5749,6590,1407,497
24966,6828,5797,5659,6231,1169,434
26553,6318,5636,5295,6023,1023,387
29956,6011,5934,5086,6357,925,423
31689,5268,5532,4408,5769,860,237
31354,4567,3842,3664,4142,903,300
31986,4383,3364,3439,3707,944,343
32718,4093,2278,3073,2570,1020,292
33164,4295,2480,3155,3030,1140,550
33264,4445,3240,3263,3942,1182,702
33372,4003,2486,2822,3175,1181,689
33205,3976,2548,2763,3367,1213,819
32949,3762,2124,2424,2887,1338,763
32821,3437,1432,2065,2189,1372,757
32784,3287,989,2111,1745,1176,756
34051,4066,1809,2973,2590,1093,781
33769,4451,1620,3446,2190,1005,570
33186,6003,3573,4657,4338,1346,765
31951,6532,4586,4993,5328,1539,742
30414,6103,3977,4666,4603,1437,626
28109,5764,3802,4367,4354,1397,552
26274,5697,3761,4291,4176,1406,415
25164,5941,4238,4608,4660,1333,422
24862,5825,4591,4654,4945,1171,354
24450,5381,4335,4297,4536,1084,201
24487,5059,4036,4071,4108,988,72
25160,4866,3888,3989,3933,877,45
26376,4795,4124,4004,4130,791,6
27892,4702,3786,3932,3868,770,82
29618,4750,4007,4023,4042,727,35
31036,4908,3690,4029,3809,879,119
31476,4970,3418,3952,3680,1018,262
31353,4825,3837,3715,4182,1110,345
30681,4256,2705,3084,2973,1172,268
30010,4301,2305,2986,2722,1315,417
29366,4421,2143,3172,2811,1249,668
28982,4271,2046,3201,2569,1070,523
29059,4245,2268,3203,2695,1042,427
29975,4051,1924,3114,2418,937,494
32212,4188,2040,3194,2540,994,500
32601,4535,2328,3566,2844,969,516
32373,4853,3022,3725,3595,1128,573
31801,4723,2849,3455,3403,1268,554
30678,4923,2716,3636,3421,1287,705
29250,4838,2813,3505,3421,1333,608
28124,4828,2632,3386,3284,1442,652
27475,4899,2328,3471,3076,1428,748
27040,4745,2206,3307,2898,1438,692
27014,4565,2101,3422,2839,1143,738
27278,4547,2415,3401,3099,1146,684
28217,4432,2490,3196,3087,1236,597
29525,4229,2164,2849,2699,1380,535
31042,3946,1703,2652,2351,1294,648
32923,3643,1432,2446,2076,1197,644
34379,3601,1387,2395,1881,1206,494
34917,3759,1595,2598,2061,1161,466
34830,3812,1818,2549,2278,1263,460
34568,3398,1378,2197,1714,1201,336
34009,3206,1379,1948,1765,1258,386
33454,2726,1098,1621,1405,1105,307
33040,2294,979,1351,1200,943,221
32906,1805,832,1118,819,687,187
33320,1437,775,839,621,598,154
35130,1086,470,621,348,465,122
35776,986,357,631,248,355,109
35670,911,259,612,194,299,65
35818,1298,772,946,617,352,155
34250,1271,772,870,673,401,99
32167,1267,822,818,648,449,174
30704,1065,605,567,399,498,206
30162,1004,614,337,392,667,222
30020,826,429,197,280,629,149
30346,666,268,143,136,523,132
31537,588,312,210,189,378,123
34436,524,329,268,234,256,95
39012,440,130,191,83,249,47
40516,462,142,144,110,318,32
39460,355,74,107,47,248,27
38477,275,42,134,7,141,35
37317,314,35,223,16,91,19
35953,331,40,248,36,83,4
34674,359,36,280,35,79,1
33711,279,17,235,16,44,1
32819,388,53,320,52,68,1
32341,459,79,379,78,80,1
32585,475,79,427,78,48,1
33905,527,98,491,97,36,1
36589,910,259,873,258,37,1
37024,1492,709,1455,695,37,14
36613,2100,1343,2055,1352,45,9
35223,2662,2038,2545,2081,117,43
32813,3102,2599,2892,2655,210,56
30203,3221,2599,2977,2682,244,83
28723,3105,2154,2784,2201,321,47
28005,3292,2535,2893,2580,399,45
27719,3269,3709,2867,3725,402,16
27848,2453,2216,2255,2222,198,6
28752,2041,1424,1855,1433,186,9
31454,1903,1777,1654,1778,249,1
35817,1247,1290,1067,1291,180,1
37092,826,1096,655,1097,171,1
35849,433,334,337,335,96,1
35324,356,154,292,153,64,1
34719,440,143,406,142,34,1
33714,793,278,721,277,72,1
32620,1139,398,1011,397,128,1
32038,1681,788,1548,771,133,17
31485,1919,776,1699,775,220,1
31211,2709,1569,2354,1570,355,1
31581,3286,2264,2809,2265,477,1
32464,3540,2438,3039,2462,501,24
34748,4158,3259,3542,3272,616,13
35248,4377,3135,3766,3141,611,6
35182,5098,4171,4352,4186,746,15
33940,5240,4409,4477,4435,763,26
31778,4871,3755,4115,3871,756,116
29622,4366,2820,3678,2958,688,138
28137,4110,2492,3457,2645,653,153
27618,4044,2815,3415,2987,629,172
27590,3680,2791,3124,2882,556,91
27889,3243,2382,2607,2517,636,135
29105,3043,2247,2536,2485,507,238
32122,2825,1777,2297,1956,528,179
36630,2782,1895,2161,2262,621,367
38019,2045,1002,1487,1294,558,292
37219,1515,830,819,646,696,314
37303,1144,704,256,314,888,458
37034,786,487,44,38,742,525
36298,616,443,14,11,602,454
35466,448,203,8,2,440,205
34841,493,283,16,1,477,284
34198,458,305,33,1,425,306
33897,375,187,43,1,332,186
33971,351,148,69,1,282,147
35014,380,184,134,14,246,170
37670,397,119,259,32,138,87
38363,591,131,501,81,90,50
38176,854,232,757,166,97,66
36979,1156,431,1019,335,137,96
34603,1633,862,1381,748,252,130
32364,2191,943,1870,1099,321,156
30947,2364,982,2026,1069,338,87
30541,2899,1350,2394,1443,505,93
30584,3425,1876,2729,1967,696,91
31026,3673,2162,2891,2295,782,133
32257,3489,2149,2804,2277,685,128
35325,3228,1892,2676,1992,552,100
39899,2934,1409,2402,1507,532,98
41065,3260,1827,2752,1914,508,87
39424,3105,1792,2628,1807,477,15
38197,3422,2413,2906,2414,516,1
37139,3014,1512,2570,1516,444,4
35740,3385,1996,2783,2002,602,6
34423,3912,3021,3181,3053,731,32
33466,3714,3846,3007,3847,707,1
32702,3066,2376,2424,2396,642,20
32406,2771,1860,2016,1885,755,25
32685,2622,2210,2058,2332,564,122
33917,1740,941,1413,978,327,37
36367,1541,717,1273,715,268,2
36646,2002,1032,1723,1034,279,2
36268,1938,639,1770,638,168,1
34835,2540,1016,2223,1017,317,1
32460,3600,2469,3234,2474,366,5
29936,3420,2133,3073,2139,347,6
28259,3662,3000,3268,3001,394,1
27459,3103,4019,2684,4028,419,9
27181,2077,3525,1725,3535,352,10
27275,1898,1170,1560,1171,338,1
28064,2452,2128,2083,2129,369,1
30504,2668,2645,2335,2646,333,1
34592,2393,2149,1905,2150,488,1
36223,2024,1057,1538,1070,486,13
35796,1986,994,1540,1051,446,57
35825,1966,1431,1539,1487,427,56
35459,1593,843,1207,819,386,24
34552,1591,913,1178,925,413,12
33590,1722,833,1246,774,476,59
32934,1949,800,1467,695,482,105
32140,2207,922,1669,1012,538,90
31548,2131,1026,1618,1159,513,133
31859,1699,764,1348,826,351,96
31888,1444,643,1130,585,314,58
34179,1970,1430,1604,1487,366,57
35010,1979,1098,1586,1114,393,16
35129,2583,1656,2110,1762,473,106
34932,2651,1468,2229,1560,422,92
34036,3153,2059,2765,2203,388,144
32867,3294,2398,2941,2537,353,139
31859,3232,2451,3016,2569,216,118
31593,3144,2027,2855,2143,289,116
31706,3521,2975,3279,3078,242,103
32143,3488,2429,3013,2562,475,133
33101,3803,2285,3197,2482,606,197
34807,4316,2481,3516,2749,800,268
37276,4714,2900,3775,3175,939,275
39402,5160,3338,4091,3595,1069,257
40756,5500,3504,4365,3876,1135,372
41021,5495,3272,4399,3688,1096,416
39901,5015,2662,4067,3072,948,410
38397,4277,2032,3504,2435,773,403
36623,3611,1539,3015,1931,596,392
34897,3116,1191,2577,1558,539,367
33573,2700,934,2207,1094,493,328
32891,2762,935,2247,1212,515,336
33167,2609,931,2114,986,495,298
35017,2777,930,2241,1173,536,292
38542,3364,1572,2879,2000,485,428
40017,3608,2105,3198,2601,410,496
40386,3737,2156,3188,2672,549,516
40018,3665,2521,2874,3230,791,709
38964,3334,1979,2498,2750,836,771
37688,3097,1344,2526,2080,571,736
36672,2928,1266,2311,1769,617,503
36078,2818,952,2078,1447,740,495
35874,2698,916,1884,1381,814,603
36104,2447,900,1552,1134,895,607
36597,2047,855,1190,611,857,614
37677,1930,808,1202,543,728,667
39299,1856,794,1215,647,641,535
40482,1932,810,1299,644,633,586
41507,1845,791,1208,521,637,465
41763,2111,859,1399,728,712,471
41019,2176,896,1360,706,816,426
39764,2372,908,1316,967,1056,509
38692,2844,933,1500,1539,1344,996
38074,2556,925,1332,1089,1224,923
37586,2866,933,1460,1701,1406,1307
37437,2692,929,1311,1425,1381,1206
37926,2792,926,1374,1719,1418,1244
39332,2914,929,1398,2067,1516,1176
41510,2576,921,1329,1344,1247,957
42126,2915,931,1627,2011,1288,1141
41689,3036,1715,1819,2953,1217,1238
40438,3308,3079,2002,4784,1306,1705
38211,3287,2834,2184,4346,1103,1512
35729,3738,4234,2305,5602,1433,1368
34052,3011,1849,2013,2545,998,696
33237,3431,2238,2440,2891,991,653
32988,3932,3090,2870,3858,1062,768
33173,3904,3586,2845,4415,1059,829
34266,4080,4339,3246,5078,834,739
36889,4311,4564,3626,5156,685,592
41122,4268,4271,3488,4771,780,500
42230,4562,4469,3824,4959,738,490
41318,4247,3022,3470,3361,777,339
41013,4650,4007,3812,4335,838,328
40649,4590,4622,3753,4787,837,165
39827,4358,3961,3646,4195,712,234
38688,4064,3493,3488,3608,576,115
37551,4437,3861,3858,3972,579,111
36255,4632,3953,4072,4037,560,84
35280,4657,4246,4260,4270,397,24
34755,3834,2907,3518,2919,316,12
35099,3068,2753,2787,2756,281,3
36894,2081,1916,1894,1917,187,1
37487,1609,1019,1505,1020,104,1
37207,1800,1445,1702,1446,98,1
36072,2272,2508,2156,2534,116,26
33702,2762,2956,2588,3037,174,81
31169,3075,2909,2800,3046,275,137
29501,3000,2587,2767,2701,233,114
28723,3069,2752,2825,2883,244,131
28518,3133,3581,2837,3660,296,79
28662,3337,3925,2919,4038,418,113
29580,3476,3796,3114,3921,362,125
32288,3526,3421,3106,3540,420,119
36782,3239,2720,2835,2772,404,52
37717,3223,2601,2775,2660,448,59
36395,2547,1664,2174,1668,373,4
35519,1995,1253,1682,1254,313,1
34809,1571,1140,1311,1141,260,1
33926,1280,769,1065,770,215,1
32889,921,298,619,277,302,21
32222,1105,362,662,285,443,77
31740,1668,865,1004,603,664,272
31501,1972,896,1220,830,752,407
31364,2033,902,1236,935,797,491
31599,1811,869,1169,605,642,521
33442,2114,889,1426,920,688,503
34096,2840,921,2053,1381,787,541
33658,4040,2339,2983,3026,1057,687
32415,4665,3564,3295,4330,1370,766
30167,4961,3849,3751,4656,1210,807
27806,4782,3189,3557,3895,1225,706
26129,5063,4237,3644,4946,1419,709
25257,4658,3810,3076,4544,1582,734
24736,4269,3767,2704,4517,1565,750
24697,3757,2897,2665,3529,1092,632
25306,3915,2614,3082,3008,833,394
27478,4747,3754,3784,4114,963,360
31693,4780,3575,3729,4043,1051,468
33009,4901,3961,4077,4587,824,626
32631,4461,2896,3795,3465,666,569
32836,5070,4063,4268,4561,802,498
33364,5341,3707,4577,4093,764,386
33562,5892,4459,5115,4762,777,303
33441,6457,5432,5688,5658,769,226
33448,6248,5207,5491,5305,757,98
33219,5748,4606,5082,4638,666,32
33037,5151,3995,4593,4011,558,16
32845,4117,2972,3671,2987,446,15
32618,2902,2055,2607,2081,295,26
34118,1989,1616,1777,1668,212,52
34640,1528,967,1377,1019,151,52
33957,1832,1339,1653,1368,179,29
32514,2375,1720,2009,1775,366,55
29980,3332,3179,2938,3298,394,119
27419,3635,2927,3200,3057,435,130
25809,3948,2766,3354,2895,594,129
25021,4602,3978,4045,4165,557,187
24779,4061,2925,3444,3102,617,177
25020,3884,2445,3100,2632,784,187
25827,3912,2455,3147,2687,765,232
28321,3706,2253,2974,2466,732,213
33028,3231,1990,2616,2113,615,123
34515,3161,1900,2516,2055,645,155
34185,2878,1709,2151,1816,727,107
34344,2436,1178,1858,1408,578,230
34465,1995,899,1442,944,553,165
34123,1910,1032,1117,1300,793,268
33506,1528,838,879,479,649,376
32910,1471,643,752,378,719,265
32351,1755,861,842,410,913,544
32035,1839,861,1014,613,825,522
32098,1578,628,896,328,682,300
32683,1891,855,1212,653,679,348
34959,2189,881,1548,1359,641,532
35648,1996,885,1283,951,713,228
35158,2188,896,1764,1139,424,430
33931,2337,1409,1904,1621,433,212
31350,2391,1611,1948,1851,443,240
28837,2445,1583,1962,1982,483,399
27245,1889,904,1505,1056,384,152
26454,1870,916,1484,1166,386,250
26036,1525,838,1267,824,258,111
26135,1461,875,1176,933,285,58
26826,1189,723,930,617,259,106
29105,1090,768,824,669,266,120
33164,810,368,552,272,258,96
34640,671,195,403,122,268,73
34217,577,209,209,99,368,110
34093,413,74,127,23,286,51
34175,351,32,78,8,273,24
33744,356,35,29,10,327,25
33118,395,141,6,16,389,125
32682,408,128,7,14,401,114
32237,612,453,24,36,588,457
31888,762,350,17,52,745,298
32021,691,431,18,30,673,461
32525,596,448,75,12,521,460
33737,571,381,148,2,423,383
33761,732,425,258,49,474,397
33113,754,286,345,43,409,243
32107,1004,591,475,206,529,385
30323,1068,525,476,218,592,307
28403,1092,468,525,231,567,237
26923,1099,410,540,175,559,235
26083,1635,849,951,527,684,424
25602,1625,850,960,660,665,413
25369,1778,850,1135,1237,643,743
25541,1554,802,1129,662,425,519
26305,1738,861,1318,858,420,336
27894,1648,746,1209,556,439,190
29287,2058,878,1459,825,599,381
30983,2369,873,1458,831,911,531
32439,2383,854,1397,864,986,755
33139,2598,882,1291,1071,1307,1101
33085,2344,863,1181,571,1163,937
32614,2792,917,1623,834,1169,926
32249,3388,920,1936,1607,1452,1104
32062,3647,921,2040,2006,1607,1201
32144,3558,920,1986,1959,1572,1206
32341,3474,919,1858,1951,1616,1193
32903,2887,912,1484,1147,1403,920
34368,2634,909,1270,998,1364,787
34777,2392,862,1156,740,1236,814
34271,2251,841,967,685,1284,814
33400,2142,800,861,737,1281,998
31773,1718,742,647,316,1071,902
30140,1513,675,397,212,1116,785
28906,1284,597,301,84,983,681
28181,1155,560,202,51,953,611
27909,1000,458,186,52,814,443
27848,945,437,280,77,665,502
28151,848,428,373,158,475,453
28944,760,436,550,307,210,310
30250,557,238,529,201,28,37
31223,663,334,654,333,9,1
32166,952,757,937,758,15,1
32451,779,381,742,380,37,1
31940,963,500,919,499,44,1
31034,1100,461,1033,460,67,1
30171,1421,698,1306,697,115,1
29183,1753,969,1579,970,174,1
28368,2231,1416,2061,1431,170,15
27911,2873,1953,2622,1979,251,26
27931,3503,2546,3122,2580,381,34
28656,4304,3878,3880,3942,424,64
31119,4300,3531,3919,3608,381,77
32596,5009,4116,4366,4207,643,91
32556,6098,5322,5189,5504,909,182
32121,6928,6625,5824,6878,1104,253
30721,7626,7696,6505,7992,1121,296
28885,7779,7991,6572,8364,1207,373
27778,7548,7604,6318,7982,1230,378
27306,7386,7232,6140,7625,1246,393
27186,7161,6884,5952,7146,1209,262
27463,6800,6059,5667,6323,1133,264
28389,6716,5804,5564,6102,1152,298
30656,6528,5445,5362,5711,1166,266
33953,6273,5120,5164,5465,1109,345
35017,5997,4977,4962,5221,1035,244
34825,5263,4022,4464,4231,799,209
34723,4464,2900,3764,3105,700,205
34716,4190,2315,3454,2510,736,195
34345,4278,2081,3358,2307,920,226
33746,5797,4498,4584,4737,1213,239
33130,6135,5203,4848,5435,1287,232
32494,6438,5892,5122,6139,1316,247
32117,6323,5569,5035,5815,1288,246
31982,6314,5574,5087,5786,1227,212
32169,6051,5327,4961,5497,1090,170
33973,5258,4608,4296,4755,962,147
34677,3751,2844,3094,2978,657,134
34003,2743,1472,2218,1639,525,167
32804,2282,1259,1766,1436,516,177
30578,2040,1213,1492,1484,548,271
28268,1705,1128,1097,1337,608,209
26884,1407,913,959,1159,448,246
26358,1075,701,739,622,336,153
26170,1435,1177,1113,1245,322,68
26539,1742,2230,1391,2263,351,33
27669,2128,2880,1841,2898,287,18
30554,2598,2861,2235,2868,363,7
35076,2615,2172,2344,2194,271,22
36134,2745,2160,2544,2187,201,27
34669,2066,1036,1890,1037,176,1
33626,1818,861,1609,862,209,1
33228,1512,416,1306,415,206,1
32806,2188,750,1903,753,285,3
32513,2737,1168,2380,1172,357,4
32521,2762,1089,2366,1101,396,12
32446,3010,1251,2537,1267,473,16
32456,3821,2005,3174,2055,647,50
32487,3774,1936,3096,2025,678,89
32079,3484,1754,2859,1887,625,133
33579,3697,1891,3060,2058,637,167
34529,3896,1753,3247,1951,649,198
34034,4680,2544,3842,2801,838,257
32477,5367,3567,4274,3830,1093,263
30053,5618,3862,4517,4162,1101,300
27490,5599,4105,4527,4425,1072,320
25787,5899,5242,4762,5450,1137,208
24933,5524,4431,4551,4567,973,136
24553,5447,4457,4636,4532,811,75
24487,5578,4897,4895,4936,683,39
25096,5626,5139,5042,5157,584,18
27453,5630,5000,5083,5013,547,13
31173,6066,5636,5479,5698,587,62
32202,6267,5987,5621,6066,646,79
31831,6138,6323,5624,6341,514,18
32030,5823,5674,5276,5688,547,14
32602,5391,4814,4668,4817,723,3
32915,5119,4171,4414,4178,705,7
33268,5394,4625,4590,4638,804,13
34086,5616,5093,4901,5098,715,5
34598,5647,5234,4938,5235,709,1
34983,5423,4704,4760,4705,663,1
35090,5064,4247,4418,4248,646,1
34300,4396,3755,3829,3775,567,20
35149,3709,2430,3167,2482,542,52
35726,4289,2731,3707,2882,582,151
34987,5613,4581,4646,4751,967,170
33384,6965,6643,5586,7009,1379,366
30891,7633,7800,6047,8332,1586,532
28181,7623,7768,6130,8290,1493,522
26288,8060,8976,6521,9552,1539,576
25233,7908,8623,6366,9109,1542,486
24711,8013,8862,6305,9240,1708,378
24626,8045,8903,6288,9288,1757,385
25212,8136,9065,6463,9521,1673,456
27336,8062,8991,6607,9391,1455,400
31174,8071,9224,6835,9648,1236,424
32322,7739,8739,6582,8968,1157,229
32025,7497,8704,6409,8770,1088,66
32360,7264,8354,6250,8372,1014,18
33108,6894,7535,5925,7559,969,24
33624,6197,5938,5308,5970,889,32
34132,6241,5830,5304,5974,937,144
34706,5909,5497,5184,5600,725,103
34777,5734,5485,5087,5557,647,72
34716,5074,4535,4573,4559,501,24
34473,4411,3209,3974,3238,437,29
34000,4237,2620,3633,2674,604,54
35102,6149,5673,5177,5764,972,91
35704,7003,7099,5850,7287,1153,188
34942,7526,7506,6108,7996,1418,490
33270,7726,7766,6225,8370,1501,604
30864,7567,7391,5991,7959,1576,568
28219,7461,6966,5820,7501,1641,535
26401,7356,7213,5864,7667,1492,454
25462,6741,6130,5472,6528,1269,398
24874,6541,5452,5263,5960,1278,508
24680,6043,4148,4879,4913,1164,765
25148,5956,3893,4548,4773,1408,880
27311,5640,3204,4033,4148,1607,944
31394,4909,2152,3361,3023,1548,871
32804,4415,1630,2968,2572,1447,942
32812,3556,909,2172,1791,1384,945
32996,3017,907,1688,1331,1329,1017
33311,2584,889,1226,980,1358,929
32875,2239,864,892,691,1347,927
32218,2409,872,868,927,1541,1326
31748,2135,850,834,598,1301,1232
31210,1918,840,693,320,1225,1019
30760,1668,768,609,194,1059,962
30620,1497,914,452,118,1045,1032
30691,1289,976,268,54,1021,1030
32364,1122,997,250,17,872,1014
33526,1007,539,219,37,788,576
33375,1169,525,326,115,843,623
32773,1525,613,594,371,931,799
31658,1825,715,949,660,876,831
30047,2269,814,1575,1230,694,773
28747,2096,892,1632,813,464,411
28156,2636,931,2086,1183,550,309
27897,3127,1201,2413,1439,714,238
27985,4374,2335,3474,2741,900,406
28619,4859,3079,4093,3489,766,410
29929,5026,3451,4221,3754,805,303
31962,5065,3776,4188,4148,877,372
33467,4728,3128,4024,3357,704,229
34328,4197,2393,3533,2587,664,194
34217,3992,2204,3385,2363,607,159
33546,4317,2706,3746,2824,571,118
32628,5121,3637,4427,3815,694,178
31441,5553,4665,4761,4741,792,76
30368,5859,5180,5040,5232,819,52
29355,5856,5272,5006,5275,850,3
28875,6085,5650,5205,5651,880,1
28738,6127,5723,5250,5730,877,7
29152,5818,5182,5023,5195,795,13
31025,5835,5283,5079,5304,756,21
32510,6374,6208,5428,6243,946,35
32604,7131,7707,6037,7772,1094,65
32286,7492,8480,6332,8572,1160,92
31155,7589,8900,6375,9001,1214,101
30081,7626,8652,6461,8765,1165,113
29145,7711,8937,6560,9041,1151,104
28608,7603,8746,6497,8847,1106,101
28416,7573,8742,6483,8809,1090,67
28528,7450,8447,6390,8528,1060,81
28944,7261,7981,6218,8071,1043,90
29856,7146,7697,6129,7785,1017,88
31196,6947,7341,5965,7428,982,87
31998,6628,6671,5674,6756,954,85
32300,5995,5639,5181,5653,814,14
31711,5270,4301,4585,4304,685,3
30582,4466,3516,3869,3533,597,17
29579,3489,2202,2994,2230,495,28
28893,3405,2064,2848,2093,557,29
28260,3168,1936,2589,1974,579,38
27687,2870,1612,2321,1683,549,71
27468,2774,1286,2255,1377,519,91
27631,3071,1404,2508,1511,563,107
28504,3461,1568,2844,1692,617,124
30469,4401,2687,3652,2844,749,157
31801,5116,3516,4182,3706,934,190
31520,6144,4873,4854,5151,1290,278
30404,6284,4870,5101,5250,1183,380
28445,6486,5468,5379,5849,1107,381
26295,6217,5214,5020,5477,1197,263
24796,5854,4654,4581,4835,1273,181
23956,5688,4565,4485,4769,1203,204
23525,5104,4568,4082,4784,1022,216
23515,3594,3624,3205,3769,389,145
24128,2340,2069,1988,2155,352,86
26417,1786,1089,1422,1179,364,90
30347,1691,846,1367,755,324,91
31586,1777,875,1371,778,406,97
31381,1763,894,1108,942,655,172
31621,1596,863,893,778,703,267
32161,1489,804,807,533,682,271
32111,1605,903,895,614,710,293
31853,1696,907,1003,720,693,276
31710,1907,913,1044,1080,863,343
31512,2369,1387,1323,1857,1046,470
31348,2390,1181,1445,1580,945,399
31397,2690,1308,1755,1682,935,374
31744,3061,1407,2190,1744,871,337
33285,4092,2475,3092,2954,1000,479
33962,4688,3184,3663,3683,1025,499
33283,5013,3164,4026,3623,987,459
31786,5471,3778,4399,4177,1072,399
29502,5858,4433,4820,4825,1038,392
26888,5894,4661,4726,4972,1168,311
25066,6137,5409,4855,5734,1282,325
24059,6457,6068,5031,6429,1426,361
23610,6680,6362,5157,6752,1523,390
23577,6838,6564,5210,6963,1628,399
24122,7116,6977,5468,7427,1648,450
26211,7313,7061,5773,7498,1540,437
29900,7549,7506,6099,7942,1450,436
31131,7545,7709,6040,8100,1505,391
31052,7764,7840,6277,8379,1487,539
31529,7837,8059,6206,8691,1631,632
32226,7712,7382,5873,8035,1839,653
32701,7766,6871,5756,7633,2010,762
32887,8237,7372,5951,8363,2286,991
33247,8296,7121,5979,8245,2317,1124
33213,8519,7490,6104,8733,2415,1243
33217,8129,6619,5810,7837,2319,1218
33310,7690,5815,5549,6980,2141,1165
33346,7031,4589,5100,5689,1931,1100
34717,6355,3493,4621,4551,1734,1058
35480,5945,2970,4277,3981,1668,1011
34718,5331,2331,3790,3272,1541,941
33093,5382,2642,3802,3587,1580,945
30521,5277,3371,3600,4430,1677,1059
27758,4738,3525,2854,4659,1884,1134
25841,3790,1834,2196,2748,1594,914
24731,3548,1462,2010,2276,1538,814
24095,3751,1566,2277,2335,1474,769
23925,4062,2052,2564,2814,1498,762
24375,4179,2226,2636,2961,1543,735
26308,4197,2848,2463,3760,1734,912
30079,4213,4074,2586,5037,1627,963
31207,3706,3288,2578,4143,1128,855
31258,3158,2809,2280,3665,878,856
31995,2321,2118,1738,3381,583,1263
32939,1340,799,733,701,607,359
33425,1102,593,496,301,606,292
33764,872,370,355,148,517,222
34344,1034,486,535,164,499,322
34749,1287,646,713,267,574,379
34999,1412,775,759,426,653,438
34997,1348,658,672,274,676,384
34518,1527,770,827,338,700,550
35164,1885,857,1174,609,711,493
35683,2440,893,1820,869,620,368
34968,3810,1857,3065,2239,745,382
33461,4901,3186,3972,3549,929,363
30858,5943,4578,4818,4962,1125,384
28140,6595,5574,5404,5975,1191,401
26167,6729,6318,5566,6648,1163,330
25137,6660,5853,5563,6267,1097,414
24641,6779,6048,5700,6520,1079,472
24650,6802,6190,5829,6634,973,444
25267,6657,6292,5780,6632,877,340
27369,6212,5512,5471,5787,741,275
31195,5793,5078,5128,5207,665,129
32528,5526,4409,4853,4547,673,138
32209,5431,4763,4799,4897,632,134
32244,4962,5193,4235,5333,727,140
32856,3695,2165,3155,2370,540,205
33342,4234,2413,3453,2600,781,187
33828,5678,4127,4423,4486,1255,359
34555,6216,4383,4796,4943,1420,560
35048,6530,4500,4973,5247,1557,747
35122,6475,4181,4859,4993,1616,812
35206,6647,4221,4932,5085,1715,864
34718,6846,4690,5140,5657,1706,967
35417,6717,4699,5277,5618,1440,919
36340,6437,4185,4987,4897,1450,712
35713,7026,4821,5379,5664,1647,843
34274,7220,5127,5571,6099,1649,972
31755,7173,5562,5585,6373,1588,811
29028,6838,5099,5339,5901,1499,802
27017,6585,4736,4999,5564,1586,828
25893,6931,5666,5345,6640,1586,974
25159,6507,5386,5220,6183,1287,797
24924,5789,4219,4677,4826,1112,607
25228,6048,4732,4850,5322,1198,590
26945,6047,5108,4945,5640,1102,532
30318,5038,3531,4051,3921,987,390
31356,4604,3556,3592,3994,1012,438
31724,3740,2724,2804,3198,936,474
32757,2701,1576,1852,1953,849,377
33722,2144,1230,1271,1886,873,656
34458,1215,690,541,340,674,350
34768,1147,682,577,333,570,757
35264,802,556,394,156,408,400
35485,601,276,294,127,307,149
35550,520,179,191,78,329,101
35151,683,228,287,72,396,156
34463,1211,412,806,133,405,279
34544,2079,896,1640,809,439,238
34881,3034,1305,2548,1494,486,189
33937,4384,2758,3706,2938,678,180
32643,5179,3875,4298,4077,881,202
30651,6141,5460,5058,5757,1083,297
28351,5917,5425,4948,5633,969,208
26636,5173,4541,4390,4703,783,162
25428,4074,3599,3478,3699,596,100
24585,3133,3108,2560,3171,573,63
24390,2289,1225,1571,1382,718,157
24601,2455,948,1585,1101,870,553
25420,2713,941,1489,1094,1224,633
26855,3203,931,1859,1485,1344,1051
28051,3070,938,1746,1303,1324,954
29427,3070,941,1561,1503,1509,1152
30193,2508,940,1246,701,1262,946
30292,2491,922,1143,802,1348,1003
29988,2405,915,907,865,1498,1217
29466,2138,880,973,447,1165,887
28937,2479,921,1395,627,1084,802
28525,3100,937,2000,1053,1100,765
28359,3904,942,2675,1732,1229,824
28342,4474,1514,3173,2356,1301,842
28551,4552,1907,3251,2769,1301,862
29783,4099,2890,2776,3948,1323,1058
31143,2355,995,1454,1747,901,752
30911,1473,837,888,492,585,457
30309,1231,722,735,336,496,386
29296,1076,674,624,320,452,354
28077,855,586,545,416,310,170
27061,748,368,622,286,126,82
26473,1007,509,951,495,56,14
26237,1286,553,1219,548,67,5
26315,1990,1253,1887,1261,103,8
26658,2645,1855,2496,1867,149,12
27626,3184,2371,2949,2380,235,9
29022,3738,2931,3371,2944,367,13
29944,4139,3880,3731,3912,408,32
30561,3616,3831,3286,3863,330,32
30209,2593,2411,2251,2437,342,26
29384,1812,1085,1451,1099,361,14
28666,1815,1210,1450,1217,365,7
28308,1791,1416,1421,1418,370,2
28080,1640,1575,1315,1576,325,1
27973,1060,464,807,449,253,15
28041,903,271,499,215,404,56
28299,886,344,314,116,572,228
28756,900,467,224,68,676,399
30031,1094,583,430,98,664,551
31762,1358,582,746,229,612,353
31275,2130,913,1353,716,777,444
30061,2926,928,1918,1535,1008,714
28105,3259,1144,2298,1875,961,731
25845,3314,1333,2462,1858,852,525
24423,3742,2215,2846,2732,896,517
23830,3605,2068,2923,2454,682,386
23721,3643,2125,3055,2392,588,267
24033,3717,2360,3205,2605,512,245
25111,3693,2568,3200,2723,493,155
27907,3718,2567,3228,2714,490,147
32420,3935,2516,3419,2668,516,152
33436,4300,3039,3696,3225,604,186
32339,4125,3505,3572,3780,553,275
31837,3103,2119,2369,2298,734,179
31734,2737,1118,1984,1395,753,277
31801,3311,1350,2562,1702,749,352
31990,4334,2049,3468,2388,866,339
32451,6123,4178,4742,4662,1381,484
32603,7208,5716,5548,6375,1660,659
32626,7352,5748,5635,6469,1717,721
32620,7507,5853,5715,6614,1792,761
32326,7644,6046,5772,6868,1872,822
33020,8050,7025,6214,7941,1836,916
34305,7780,6507,6011,7268,1769,761
33568,8088,7111,6236,7888,1852,777
32022,8435,7871,6534,8705,1901,834
29458,8543,8240,6635,9016,1908,776
26867,8483,8486,6510,9294,1973,808
25089,8414,8501,6327,9298,2087,797
24148,8581,8664,6324,9557,2257,893
23745,8500,8185,6133,9179,2367,994
23712,8535,8029,6222,9126,2313,1097
24426,8539,8179,6358,9226,2181,1047
26638,8347,7595,6313,8462,2034,867
30552,8312,6921,6346,7770,1966,849
31456,8476,7394,6436,8366,2040,972
31244,8444,7527,6459,8536,1985,1009
31591,8163,6762,6069,7671,2094,909
31901,8464,6820,6221,7981,2243,1161
32132,8647,7075,6341,8325,2306,1250
32186,8667,7092,6359,8345,2308,1253
32412,8721,7200,6399,8459,2322,1259
32389,8781,7329,6468,8615,2313,1286
32282,8755,7243,6420,8522,2335,1279
32185,8855,7490,6438,8792,2417,1302
32150,8853,7472,6395,8759,2458,1287
33339,8933,7666,6501,8967,2432,1301
34452,8976,7713,6571,8977,2405,1264
33939,8947,7702,6531,8942,2416,1240
32385,8946,7649,6506,8920,2440,1271
29847,8829,7329,6458,8583,2371,1254
27252,8918,7890,6412,9174,2506,1284
25547,8867,7932,6318,9235,2549,1303
24623,8880,8126,6406,9477,2474,1351
24085,8805,8383,6480,9639,2325,1256
23963,8653,8365,6460,9495,2193,1130
24405,8486,8114,6358,9140,2128,1026
26381,8542,8010,6415,9031,2127,1021
30072,8459,7482,6378,8454,2081,972
31160,8406,7315,6402,8357,2004,1042
31316,8217,6939,6225,7876,1992,937
31977,8108,6373,6004,7373,2104,1000
32726,8236,6230,6091,7392,2145,1162
33162,8042,5801,5967,6925,2075,1124
33368,7801,5368,5801,6468,2000,1100
33569,7381,4696,5487,5749,1894,1053
33401,6874,4145,5053,5201,1821,1056
33259,6574,3993,4753,5061,1821,1068
33332,6106,3070,4474,4063,1632,993
33458,6527,3489,4838,4483,1689,994
34489,7189,4587,5207,5712,1982,1125
35389,7340,4676,5294,5795,2046,1119
34991,7446,4520,5509,5572,1937,1052
33666,7962,5415,5885,6533,2077,1118
31251,7794,5334,5758,6479,2036,1145
28644,7679,5356,5548,6539,2131,1183
26742,7292,5167,5131,6375,2161,1208
25677,6412,3916,4504,4986,1908,1070
24973,6098,3997,4071,5089,2027,1092
24720,5397,3173,3403,4439,1994,1266
24926,4620,2589,2510,3999,2110,1410
26896,3664,1360,1725,2981,1939,1621
30647,2710,917,1620,930,1090,943
32114,3568,939,2618,1607,950,768
32480,5191,2638,3784,3354,1407,716
33398,7457,6014,5508,6957,1949,943
34333,8128,6767,6067,7890,2061,1123
34827,8324,6968,6203,8053,2121,1085
35054,8557,7068,6405,8226,2152,1158
35357,8458,6796,6346,7945,2112,1149
35389,8469,6796,6372,7907,2097,1111
35599,8406,6548,6363,7625,2043,1077
35852,8398,6582,6339,7662,2059,1080
35991,8374,6708,6271,7795,2103,1087
36905,8466,6881,6374,8008,2092,1127
37478,8355,7095,6497,8184,1858,1089
37014,7943,6846,6281,7594,1662,748
35592,7825,6815,6508,7446,1317,631
33083,7431,6788,6411,7141,1020,353
30378,7192,6924,6112,7090,1080,166
28567,7033,6213,5690,6473,1343,260
27694,7086,6024,5683,6594,1403,570
27187,6179,5022,5100,5577,1079,555
27224,5609,3741,4497,4192,1112,451
27933,5916,3697,4451,4141,1465,444
30417,6661,4398,4983,5258,1678,860
34459,6437,4277,4780,5164,1657,887
35930,5872,3730,4317,4611,1555,881
36137,5466,3531,4025,4326,1441,795
36681,5176,3201,3780,3872,1396,671
37064,4999,2729,3675,3393,1324,664
37164,5054,2779,3670,3341,1384,562
36927,5275,3114,3842,3820,1433,706
36760,4915,2704,3480,3287,1435,583
36179,4846,2597,3474,3230,1372,633
35886,4596,2789,3229,3478,1367,689
36318,3803,2088,2534,2781,1269,693
36691,2937,1006,1858,1707,1079,701
37671,2479,932,1475,1351,1004,640
37965,1968,888,1182,718,786,486
37166,1942,886,1266,769,676,436
35847,2035,882,1348,1049,687,418
33889,1850,867,1260,814,590,338
31785,1859,857,1279,951,580,338
30165,1682,849,997,933,685,387
29167,1221,697,836,354,385,343
28655,1018,468,619,322,399,146
28438,915,416,552,228,363,188
28573,763,255,464,117,299,138
29382,808,257,474,128,334,129
30700,906,451,557,234,349,217
31865,751,343,398,179,353,164
33265,588,264,309,67,279,197
34330,471,108,266,22,205,86
34792,550,183,339,95,211,88
34562,528,236,381,150,147,86
34004,459,57,348,56,111,1
33340,518,226,312,224,206,2
32882,420,30,189,20,231,10
32647,522,375,288,238,234,250
32564,384,330,277,296,107,34
33000,255,64,236,63,19,1
33999,419,336,414,337,5,1
34296,427,416,426,417,1,1
33584,343,166,333,165,10,1
32461,328,190,325,189,3,1
30890,339,147,284,146,55,1
29200,394,343,320,297,74,46
27681,268,110,74,109,194,1
26624,323,27,157,4,166,23
25808,516,142,338,75,178,67
25605,658,138,539,100,119,38
25754,1034,545,899,479,135,66
26565,1157,503,1005,497,152,6
27604,1517,841,1243,830,274,11
28266,1724,880,1367,897,357,70
29181,2159,1424,1769,1581,390,157
29829,2245,1526,1875,1622,370,96
30009,2542,1629,2285,1715,257,86
29869,3202,2121,2897,2124,305,3
29258,4275,3456,3848,3457,427,1
28600,4800,4028,4283,4030,517,2
28180,5171,4563,4715,4564,456,1
28087,5289,4656,4762,4657,527,1
28268,5359,4688,4759,4689,600,1
28409,5176,4608,4596,4616,580,8
29400,4887,5068,4360,5105,527,37
30922,4080,2887,3591,2915,489,28
30430,4928,3697,4278,3757,650,60
29154,5607,5056,4810,5134,797,78
27056,5996,5890,5235,6007,761,117
25346,5664,4852,4984,4991,680,139
24350,5890,5258,4969,5361,921,103
23882,6175,5404,5078,5661,1097,257
23819,6513,6118,5446,6438,1067,320
24314,6426,6440,5540,6603,886,163
26052,5969,5855,5254,5951,715,96
28599,5466,4909,4869,4971,597,62
30504,5189,4402,4623,4451,566,49
30913,4981,4301,4445,4356,536,55
31357,4414,4253,3944,4305,470,52
31714,3348,3466,2939,3467,409,1
31847,2241,1754,1971,1755,270,1
31846,1819,1274,1585,1275,234,1
32272,1542,906,1368,907,174,1
32637,1423,632,1247,621,176,11
32990,1640,776,1378,750,262,26
33342,2010,1035,1635,1088,375,53
33447,2240,1170,1765,1252,475,82
33306,2476,1674,1949,1808,527,134
33613,2227,1311,1764,1436,463,125
34704,2344,1045,1770,1140,574,95
33510,3319,1794,2561,2057,758,263
31528,3941,2489,3161,2841,780,352
28966,4159,2527,3459,2873,700,346
26791,4702,3051,3945,3386,757,335
25631,5479,3840,4438,4203,1041,363
24903,6281,5612,5175,5967,1106,355
24537,6659,7024,5659,7331,1000,307
24691,6134,6290,5256,6544,878,254
25971,5181,4504,4437,4763,744,259
28034,4479,3833,3860,4106,619,273
29865,3681,2554,3091,2755,590,201
30266,3430,2201,2917,2411,513,210
31264,3214,2488,2743,2655,471,167
32457,2610,1227,2266,1358,344,131
33329,3180,1636,2700,1863,480,227
33743,3592,1956,2777,2327,815,371
34344,3580,1545,2505,2050,1075,505
34742,3707,1276,2424,2014,1283,738
35165,3745,1073,2418,1846,1327,773
35467,3987,1217,2794,2095,1193,878
35278,4281,1431,2900,2204,1381,773
34765,4830,1995,3283,2859,1547,864
34911,5561,3100,3932,4089,1629,989
35890,5830,3602,4311,4447,1519,845
34826,6259,4069,4694,4840,1565,771
32795,6422,4128,4793,4939,1629,811
30104,6570,4443,4881,5304,1689,861
27709,6775,4988,5061,5904,1714,916
26367,6693,4996,5016,5817,1677,821
25453,6573,4713,4871,5526,1702,813
25037,6543,4613,4874,5472,1669,859
25154,6250,4399,4858,5167,1392,768
26421,5932,4216,4743,4855,1189,639
28741,5652,4039,4592,4554,1060,515
30371,5134,3553,4083,3973,1051,420
30721,4927,3845,3863,4248,1064,403
31711,4309,3036,3326,3360,983,324
33013,4119,2617,3007,2968,1112,351
34063,4255,2509,2878,3123,1377,614
34739,4008,1676,2661,2494,1347,818
35454,4031,1548,2596,2483,1435,935
35887,3865,1253,2426,2255,1439,1002
36161,3720,1029,2312,1976,1408,947
36255,3773,1073,2282,1988,1491,915
35968,3944,1387,2447,2402,1497,1015
35299,3574,994,2450,1844,1124,850
35316,3841,1664,2866,2595,975,931
36047,3619,1665,2881,2243,738,578
35030,4065,1952,3200,2330,865,378
32959,5309,3158,4156,3668,1153,510
30476,6140,4037,4745,4645,1395,608
28257,6429,4443,4917,5136,1512,693
26804,6519,4732,5066,5410,1453,678
25780,6164,4374,4848,5008,1316,634
25442,5897,4079,4848,4606,1049,527
25589,5864,4248,4763,4632,1101,384
26768,6100,4706,4862,5160,1238,454
28983,5579,4375,4515,4816,1064,441
30609,4775,3276,3906,3623,869,347
31179,4601,3081,3673,3376,928,295
32379,4548,2809,3508,3178,1040,369
33823,4518,2510,3478,2922,1040,412
34974,4722,2590,3626,3133,1096,543
35817,4656,2638,3474,3294,1182,656
36619,4108,2060,2903,2722,1205,662
37155,3625,1513,2645,2256,980,743
37527,3313,1343,2572,2045,741,702
37597,3167,1042,2204,1614,963,572
37196,3305,1060,2329,1718,976,658
36278,3392,1235,2497,1882,895,647
36062,3753,1543,2896,2381,857,838
36873,3624,1636,2809,2049,815,413
35788,4573,2535,3661,2968,912,433
33576,5531,4035,4477,4568,1054,533
30916,5505,3776,4425,4364,1080,588
28643,5579,3706,4477,4315,1102,609
27240,5758,3646,4479,4237,1279,591
26294,6566,4727,4980,5477,1586,750
25811,6756,5216,5062,6000,1694,784
25854,6316,4470,4830,5170,1486,700
26973,6206,4428,4910,5080,1296,652
29214,6316,4806,5264,5309,1052,503
30632,5631,3849,4676,4221,955,372
31151,5683,3938,4694,4342,989,404
32443,5622,3487,4420,3924,1202,437
34041,6152,3724,4666,4385,1486,661
35110,6686,4034,4998,4905,1688,871
35859,6588,3653,4920,4595,1668,942
36540,6351,3381,4742,4316,1609,935
37092,6189,3199,4675,4138,1514,939
37479,6117,3010,4563,3891,1554,881
37385,6791,3949,4959,4953,1832,1004
36635,7178,4587,5278,5698,1900,1111
35353,7296,5076,5340,6217,1956,1141
35303,6848,4117,5124,5115,1724,998
35941,6750,4086,5181,5052,1569,966
34973,6717,4280,5101,5111,1616,831
33222,6810,4494,5208,5362,1602,868
31012,6665,4571,4965,5292,1700,721
28872,6832,4685,5037,5506,1795,821
27351,6966,4882,5090,5768,1876,886
26230,6924,5127,5113,6115,1811,988
25556,6431,4529,4915,5271,1516,742
25320,6483,5347,4962,6081,1521,734
25569,5842,3949,4520,4515,1322,566
26529,6119,3972,4752,4494,1367,522
27615,6637,4301,5154,4990,1483,689
28383,6688,4304,5118,5074,1570,770
30014,6466,3920,4944,4720,1522,800
31732,6419,3593,4909,4364,1510,771
32954,6859,4058,5163,4982,1696,924
33673,6889,4098,5147,5078,1742,980
34079,6436,3739,4656,4703,1780,964
34194,5943,3062,4167,4027,1776,965
34434,5710,2587,4043,3490,1667,903
34571,6142,2822,4522,3715,1620,893
34477,7033,3994,5225,4996,1808,1002
34021,7768,5255,5786,6358,1982,1103
34119,8314,6619,6352,7831,1962,1212
34970,8180,6762,6485,7814,1695,1052
34049,7927,6565,6298,7376,1629,811
32484,8231,7515,6495,8290,1736,775
30466,8105,7376,6292,8171,1813,795
28231,8055,7525,6148,8405,1907,880
26789,7832,7249,6074,8140,1758,891
25809,7874,7966,6216,8733,1658,767
25219,7781,8145,6192,8794,1589,649
24826,7550,7441,5946,8110,1604,669
25008,7579,7509,5995,8193,1584,684
25583,7290,6499,5807,7125,1483,626
26420,7015,5495,5496,6091,1519,596
27204,6885,4527,5301,5311,1584,784
28884,7212,4531,5542,5423,1670,892
30292,7693,5259,5810,6227,1883,968
31424,7973,5569,6046,6650,1927,1081
32466,8225,5949,6240,7039,1985,1090
33039,8391,6170,6345,7254,2046,1084
33374,8535,6272,6426,7396,2109,1124
33555,8659,6402,6515,7556,2144,1154
33664,8736,6519,6579,7680,2157,1161
33812,8804,6726,6639,7890,2165,1164
33815,8812,6910,6735,8059,2077,1149
34770,8672,6950,6722,8006,1950,1056
35952,8604,6904,6606,7823,1998,919
35114,8730,6878,6618,7937,2112,1059
33052,8841,6998,6641,8180,2200,1182
30252,8842,7222,6666,8487,2176,1265
27974,8701,7490,6328,8698,2373,1208
26532,8754,7761,6263,9110,2491,1349
25748,8373,7074,6012,8378,2361,1304
25489,7822,6158,5803,7485,2019,1327
25943,7440,5892,5572,6927,1868,1035
27821,7021,5342,5119,6080,1902,738
31340,6672,4539,4695,5519,1977,980
33002,5596,3501,3623,4568,1973,1067
32766,4459,1794,3153,2659,1306,865
33536,4460,1782,3106,2646,1354,864
34646,4516,1870,2941,2903,1575,1033
35632,4457,1684,3018,2730,1439,1046
36373,4619,1523,3402,2410,1217,887
37037,5635,2604,4220,3590,1415,986
37362,6100,3066,4507,4053,1593,987
37562,6335,3696,4401,4808,1934,1112
37451,5774,4703,3131,6442,2643,1739
37112,3344,900,1525,2176,1819,1548
36696,2682,907,941,1220,1741,1528
36748,2291,831,1255,422,1036,884
37047,3383,925,2390,1159,993,806
35616,4512,1321,3308,2195,1204,874
32968,5680,3889,3282,5419,2398,1530
29861,4057,1929,1822,3794,2235,1865
27720,2738,930,1239,1050,1499,1260
26096,2699,948,1341,918,1358,1051
25194,2993,948,1342,1484,1651,1239
24799,2875,945,1559,1269,1316,1076
25032,2795,911,1698,999,1097,767
26662,3392,1067,2202,2010,1190,943
30032,3299,1192,2319,1962,980,770
32129,3481,1441,2466,2157,1015,716
31906,3501,1366,2812,2056,689,690
32054,3584,1840,2922,2243,662,403
32124,3729,2384,2915,2812,814,428
32100,3407,2153,2563,2698,844,545
31951,2842,1035,2250,1472,592,437
31983,3255,1409,2800,1733,455,324
32084,4012,2330,3457,2524,555,194
32038,4672,3114,3937,3411,735,297
32119,4569,2968,3702,3326,867,358
31977,4290,2513,3384,2914,906,401
31808,3992,2029,3294,2565,698,536
32431,3636,2086,3051,2506,585,420
33456,3160,2030,2706,2351,454,321
32396,2618,1762,2243,2036,375,274
30055,2205,1272,2015,1426,190,154
27278,2241,1552,2083,1634,158,82
25412,2356,1643,2115,1715,241,72
24427,2371,1558,2050,1680,321,122
23858,2406,1629,2236,1775,170,146
23712,2420,1558,2234,1595,186,37
24184,2853,2134,2557,2168,296,34
26122,2840,2089,2615,2139,225,50
30002,2871,2188,2582,2197,289,9
32027,2941,2025,2682,2055,259,30
31350,3246,2673,2870,2711,376,38
31429,3032,2830,2509,2852,523,22
31671,2481,1220,2110,1284,371,64
31728,3253,1816,2782,1946,471,130
31633,3904,2617,3465,2793,439,176
31842,4121,2817,3594,2910,527,93
31943,4618,3015,4005,3196,613,181
32077,5131,3839,4370,3954,761,115
32246,5415,4759,4664,4959,751,200
32181,4613,3542,3914,3673,699,131
32012,4259,2717,3622,2911,637,194
32234,4412,3393,3698,3635,714,242
33553,3736,2834,2911,3083,825,249
32500,3109,1667,2175,2048,934,381
30142,2831,1422,1662,2072,1169,650
27446,2109,884,750,1340,1359,977
25507,1400,761,490,162,910,753
24483,1438,701,774,143,664,558
23905,2005,896,1406,587,599,463
23827,2851,1052,2238,1501,613,449
24364,3355,1732,2687,2119,668,387
26371,3679,2375,2946,2785,733,410
30407,3621,1561,2900,1837,721,276
32258,5133,3171,4011,3605,1122,434
31672,5556,3827,4459,4316,1097,489
31943,5447,4440,4633,4877,814,437
32469,4648,3816,3913,3993,735,177
32724,4557,2908,3783,3091,774,183
32892,5491,4404,4669,4698,822,294
33224,5206,4149,4364,4356,842,207
33478,4955,3881,4021,4072,934,191
33950,4550,2949,3344,3251,1206,302
34396,4423,2558,2988,3196,1435,638
34339,3753,1904,2398,2730,1355,826
33933,2750,927,1776,1381,974,529
33847,2682,1015,1718,1534,964,519
34935,2567,901,1604,1385,963,531
33692,2495,868,1634,1277,861,480
31102,2541,1151,1829,1759,712,608
28126,2073,879,1499,1352,574,529
26049,1704,755,1152,929,552,357
24859,1704,737,1145,774,559,374
24214,1853,747,1310,733,543,365
24108,2266,877,1577,1314,689,464
24552,2009,876,1498,886,511,398
26462,2143,933,1690,1113,453,299
30283,2050,982,1679,1180,371,198
32019,1909,1193,1571,1397,338,204
31407,1292,762,1127,624,165,138
31559,949,828,860,987,89,159
31999,397,163,395,162,2,1
32299,252,31,244,30,8,1
32685,284,35,207,34,77,1
33485,215,9,92,8,123,1
34282,302,52,67,10,235,42
35141,456,311,96,9,360,320
35842,389,172,63,8,326,164
35857,464,250,71,10,393,240
35057,545,327,126,10,419,329
34146,732,327,314,17,418,310
34639,1031,330,737,136,294,194
33272,1643,798,1283,627,360,171
31262,2449,1326,1988,1571,461,245
28763,2687,1398,2226,1593,461,195
26580,3219,1906,2713,2077,506,171
25125,3616,2402,3152,2561,464,159
24192,3766,2786,3223,2909,543,123
23728,3626,2866,3117,2990,509,124
23661,3340,2652,2925,2752,415,100
24243,3010,2018,2661,2096,349,78
25508,3119,2548,2804,2631,315,83
26724,2703,2388,2438,2444,265,56
27829,2027,1838,1803,1854,224,16
29130,1282,1243,1144,1244,138,1
30302,541,143,520,142,21,1
31126,389,48,348,47,41,1
31803,360,25,235,24,125,1
32627,409,90,199,42,210,48
33586,514,145,237,33,277,112
34743,616,155,257,7,359,148
35809,850,358,343,45,507,313
36358,921,366,421,70,500,296
35916,1147,485,700,230,447,255
35006,1641,839,1299,635,342,204
35405,2564,1223,2173,1345,391,122
34079,4024,2666,3495,2794,529,128
32000,4994,3842,4329,3976,665,134
29469,5406,4252,4721,4376,685,124
27046,5769,5131,5028,5276,741,145
25500,5834,5748,5092,5837,742,89
24486,5604,5491,5049,5562,555,71
23830,5081,4609,4666,4655,415,46
23516,4758,4416,4423,4453,335,37
23475,4225,3648,3922,3678,303,30
24111,3982,3282,3702,3313,280,31
24649,3738,2951,3506,2966,232,15
25910,3369,2590,3128,2595,241,5
27649,2925,2791,2699,2792,226,1
29322,1994,1324,1773,1325,221,1
30907,1898,1518,1781,1519,117,1
32503,1668,1048,1544,1049,124,1
33999,1956,971,1709,1000,247,29
35427,2721,1636,2304,1755,417,119
36719,3156,2174,2628,2372,528,198
37747,3288,2017,2722,2277,566,260
38259,3594,2357,2976,2628,618,271
37857,3816,2640,3186,2923,630,283
37100,4052,3071,3398,3368,654,297
37728,4233,3073,3531,3357,702,284
36204,4600,3116,3836,3378,764,262
33206,5300,4055,4488,4357,812,302
29613,5392,4062,4641,4326,751,264
27051,5683,4568,4873,4793,810,225
25503,6123,5470,5217,5667,906,197
24525,6072,5666,5198,5839,874,173
24138,5900,5538,5128,5667,772,129
24459,5534,4843,4834,4918,700,75
26331,5701,5116,4966,5159,735,43
29863,5523,4641,4834,4677,689,36
31271,5333,4381,4657,4395,676,14
31314,5066,4318,4357,4334,709,16
32483,4592,3877,4030,3913,562,36
33935,4337,3378,3803,3447,534,69
35431,4573,3476,3960,3584,613,108
36819,4809,3526,4144,3636,665,110
38307,5202,4224,4326,4400,876,176
39518,5516,4933,4437,5279,1079,346
40753,5669,4498,4574,4815,1095,317
41782,5758,4011,4715,4407,1043,396
41727,5766,4015,4674,4426,1092,411
40622,5980,4283,4816,4729,1164,446
39283,6136,5182,4967,5703,1169,521
39717,5472,4475,4151,5013,1321,538
37635,4880,2810,3720,3309,1160,499
34162,5593,4152,4360,4683,1233,531
30596,5652,3671,4639,4074,1013,403
28045,7003,6210,5621,6601,1382,391
26478,7584,7383,6028,7860,1556,477
25602,7375,6964,5806,7427,1569,463
25127,6959,6249,5581,6784,1378,535
25361,6143,5066,5039,5483,1104,417
26974,5561,5377,4583,5676,978,299
30538,4563,5151,3709,5346,854,195
31968,3407,2874,2848,2993,559,119
31564,3409,2699,2676,2880,733,181
32507,3333,2503,2382,2782,951,279
33701,3217,1772,2117,2249,1100,477
34724,3458,2058,2247,2856,1211,798
35554,3087,945,2215,1343,872,398
36601,4099,2036,2743,2865,1356,829
37661,3499,1508,2038,2517,1461,1009
38635,2891,840,1538,1644,1353,852
39188,2812,858,1486,1441,1326,860
39002,2767,903,1621,1088,1146,756
38213,3319,909,2233,1551,1086,649
37639,4716,2248,3619,2855,1097,607
38729,5792,3324,4498,3918,1294,594
37164,6707,4277,5267,5020,1440,743
34176,7233,5422,5847,6251,1386,829
30721,6516,5007,5259,5557,1257,550
28105,6042,4436,4737,4880,1305,444
26665,5899,4200,4508,4758,1391,558
25765,5815,4300,4304,4971,1511,671
25349,5322,3648,4132,4345,1190,697
25574,4919,3974,3847,4307,1072,333
27312,4250,3079,3459,3447,791,368
30912,3718,2683,3224,2926,494,243
32438,3343,2672,3100,2852,243,180
32208,2741,2373,2510,2496,231,123
33002,2046,1225,1667,1471,379,246
33959,1467,768,991,471,476,297
34788,1481,761,807,325,674,436
35618,1806,829,684,686,1122,993
36764,1552,826,635,243,917,679
37318,1675,831,740,201,935,652
37693,2014,883,1063,301,951,621
38165,2938,928,1704,1267,1234,949
37850,2875,939,1637,1281,1238,882
37081,2825,945,1657,1047,1168,727
36732,3638,944,2483,1837,1155,898
37630,4317,1957,3211,2698,1106,741
36462,4926,2703,3800,3354,1126,651
33717,5399,3183,4384,3948,1015,765
30474,5489,3433,4349,3880,1140,447
28068,5967,3840,4754,4480,1213,640
26658,5760,3859,4660,4378,1100,519
25766,5545,4268,4666,4606,879,338
25369,5203,4456,4549,4793,654,337
25632,4423,3383,3641,3572,782,189
27327,4273,3182,3645,3644,628,462
30992,3754,2906,3335,3201,419,295
32660,3104,2337,2801,2475,303,138
32488,2562,1850,2279,1939,283,89
33359,2025,1352,1700,1416,325,64
34432,1577,861,1194,808,383,156
35132,1696,866,1253,825,443,430
35700,1424,824,923,641,501,387
36558,1109,551,593,247,516,304
37133,1208,613,519,196,689,417
37720,1408,694,514,148,894,601
38190,1745,772,794,193,951,799
38044,2057,839,1213,423,844,749
37230,2765,928,2108,1085,657,608
36889,3816,1801,2832,2122,984,321
37867,5343,3160,4157,3962,1186,802
36449,5446,3355,4255,3796,1191,441
33789,6048,3704,4804,4351,1244,647
30632,6225,4455,5029,5104,1196,649
28272,5882,3988,4708,4667,1174,679
26812,5550,3307,4513,3962,1037,655
26080,5726,3618,4692,4231,1034,613
25675,5671,3997,4802,4492,869,495
25859,5410,4630,4814,4938,596,308
27417,4859,4833,4391,4855,468,22
30989,4191,3878,3732,3879,459,1
32741,3911,3518,3424,3523,487,5
32732,3500,2816,3006,2864,494,48
33618,3238,2872,2805,2961,433,89
34886,2478,2787,2260,2803,218,16
36145,1445,962,1400,965,45,3
37583,1186,588,1126,581,60,7
39035,1065,426,946,404,119,22
40197,1114,426,874,363,240,63
41229,1235,441,829,237,406,204
41939,1704,833,964,438,740,395
41701,2014,889,998,579,1016,748
40395,1960,901,868,521,1092,960
39052,1729,848,606,491,1123,1057
39233,1532,789,686,379,846,791
37680,1648,823,816,677,832,499
35339,1797,873,1009,570,788,424
32370,2304,928,1458,1015,846,566
29761,2468,930,1591,1362,877,524
27900,2429,942,1759,1085,670,309
26566,3283,1721,2549,1886,734,165
25831,4310,3351,3361,3561,949,210
25541,4438,3672,3548,3935,890,263
25939,4182,3329,3445,3462,737,133
27012,3928,3267,3365,3338,563,71
28065,3342,3043,2910,3060,432,17
29367,2538,2104,2192,2114,346,10
31163,1949,1948,1733,1975,216,27
33093,1022,685,949,672,73,13
34915,611,192,579,179,32,13
36791,523,113,506,112,17,1
38623,573,138,510,126,63,12
40374,666,270,458,193,208,77
41947,711,194,315,55,396,139
42893,862,386,302,26,560,360
43007,1045,532,403,44,642,488
41868,1274,665,516,106,758,559
40172,1524,815,778,276,746,739
39940,1687,854,1102,542,585,433
38245,2434,1013,1762,1420,672,407
35799,3167,1614,2512,2021,655,407
33145,3700,1692,3200,1988,500,296
30420,5405,3859,4815,4177,590,318
28603,6567,6123,5768,6398,799,275
27298,6565,5876,5704,6149,861,273
26405,6664,6010,5640,6247,1024,237
25953,6844,6365,5758,6612,1086,247
25992,6684,6009,5695,6306,989,297
26561,6535,5919,5552,6106,983,187
27097,6292,5445,5368,5639,924,194
28423,5970,5229,5134,5437,836,208
30476,5374,4709,4575,4903,799,194
32774,4622,3293,3784,3525,838,232
34983,4538,3106,3495,3392,1043,286
37146,4459,2816,3117,3242,1342,426
39192,4429,2367,3014,3145,1415,778
40895,4279,2026,3062,2791,1217,765
42266,4482,2314,3254,2998,1228,684
43218,4669,2421,3514,3148,1155,727
43396,4714,2627,3607,3285,1107,658
42459,4729,2778,3627,3297,1102,519
41177,5172,3330,3840,3877,1332,547
41494,5735,3342,4407,3997,1328,655
40061,6639,4167,5142,4836,1497,669
37185,7831,5838,6088,6651,1743,813
33630,7827,6069,6115,6891,1712,822
30821,7578,5965,6081,6745,1497,780
29117,7422,6314,5999,6861,1423,547
28006,7642,6967,6147,7446,1495,479
27373,7589,6779,6142,7300,1447,521
27671,7070,6017,6094,6528,976,511
29338,6422,5644,5553,5806,869,162
32641,5973,4994,4940,5131,1033,137
33840,5961,4920,4818,5380,1143,460
33776,5467,4158,4156,4772,1311,614
34678,4764,2915,3443,3502,1321,587
36002,4573,2063,3274,2728,1299,665
37240,5204,3256,3490,4228,1714,972
38516,4422,2373,2706,3342,1716,969
40024,4004,1928,2435,2889,1569,961
41354,4094,2338,2388,3286,1706,948
42446,4023,2015,2297,3164,1726,1149
43331,4053,1683,2532,2819,1521,1136
43133,4321,1762,2968,2705,1353,943
41934,4718,2090,3235,3090,1483,1000
40915,4885,2291,3467,3361,1418,1070
41504,4627,2009,3424,3101,1203,1092
39965,4272,1878,3177,2756,1095,878
36779,4076,1824,2954,2621,1122,797
33186,3812,1227,2792,2036,1020,809
30552,3833,1631,2602,2711,1231,1080
29005,2958,1148,1806,1962,1152,814
28108,2315,896,1270,1163,1045,703
27621,1995,902,1011,643,984,649
27883,2268,925,1067,974,1201,936
29844,2180,915,879,814,1301,861
33588,2210,909,858,680,1352,970
34982,2369,914,961,828,1408,1272
34981,2014,834,768,579,1246,1215
36083,1785,838,620,446,1165,1184
37279,1601,850,758,287,843,662
38314,2019,879,1438,502,581,509
39382,2913,1330,2391,1865,522,535
40247,2799,1439,2433,1578,366,139
40826,3392,2379,2988,2531,404,152
41307,3369,2373,2879,2450,490,77
41547,3645,2528,2939,2709,706,181
41120,3542,2194,2781,2448,761,254
40066,3326,1922,2561,2171,765,249
39197,3183,2155,2438,2516,745,361
39492,2628,1910,2117,2272,511,362
37819,1923,983,1604,1073,319,90
34737,2327,1395,1968,1485,359,90
31232,2771,1680,2427,1778,344,98
28705,3234,2298,2823,2320,411,22
27140,3669,3365,3200,3378,469,13
26249,3248,2672,2777,2680,471,8
25840,2951,2370,2487,2372,464,2
26059,2776,2740,2270,2745,506,5
27801,1990,1584,1653,1613,337,29
31459,1529,875,1233,917,296,42
32967,1477,1465,1213,1511,264,46
32555,947,940,875,941,72,1
33190,607,326,570,325,37,1
34061,547,451,544,450,3,1
34853,470,144,432,143,38,1
35612,634,156,565,155,69,1
36736,1012,379,915,378,97,1
37995,1501,655,1317,654,184,1
39326,2371,1635,2047,1636,324,1
40566,2689,1951,2340,1968,349,17
40776,2632,1804,2341,1825,291,21
39942,2328,1555,2072,1557,256,2
38753,2167,1868,1893,1901,274,33
39226,1697,1742,1399,1797,298,55
37681,1198,492,965,466,233,26
34494,1618,876,1199,910,419,34
30871,1887,1076,1484,1109,403,33
28308,2044,1462,1539,1554,505,92
26726,1790,1226,1274,1371,516,145
25737,1510,1006,1074,1190,436,184
25273,1159,836,832,874,327,113
25515,870,491,608,368,262,123
27231,753,287,555,216,198,71
30820,735,229,542,165,193,64
31981,797,216,503,165,294,51
32193,880,373,549,251,331,122
33184,673,273,322,182,351,91
34615,369,120,138,21,231,99
36005,256,106,95,22,161,84
37459,208,27,124,21,84,6
39259,200,68,177,67,23,1
40901,195,12,108,11,87,1
42284,236,8,46,7,190,1
43257,394,61,46,2,348,59
43322,653,281,176,4,477,277
41971,996,390,559,76,437,314
40082,1631,854,1302,608,329,246
40006,2633,1431,2215,1623,418,192
38249,3461,2230,2967,2465,494,235
35444,4004,2786,3436,3080,568,294
32071,4138,2849,3508,3110,630,261
28948,4296,3101,3660,3410,636,309
27168,4128,2821,3517,3042,611,221
26046,4346,3096,3648,3356,698,260
25377,4260,3366,3616,3557,644,191
25153,3946,3004,3382,3138,564,134
25955,3790,2706,3220,2812,570,106
27760,3906,2881,3330,2998,576,117
28533,3813,2768,3281,2885,532,117
29823,3772,2959,3225,3052,547,93
31781,3628,2795,3078,2901,550,106
33546,3606,2625,3020,2719,586,94
34934,3713,2713,3105,2808,608,95
36240,3717,2298,3111,2440,606,142
37625,4251,2673,3534,2905,717,232
39030,4585,3042,3743,3349,842,307
40293,4687,3181,3752,3532,935,351
41012,4758,3160,3767,3570,991,410
40844,4815,3024,3815,3445,1000,421
39578,5170,3157,4124,3591,1046,434
37878,5879,3985,4673,4553,1206,568
37998,6200,4374,5039,4993,1161,619
36586,6335,4256,5219,4791,1116,535
34378,7095,5708,5778,6186,1317,478
31524,7263,6241,5917,6680,1346,439
28850,6900,5711,5658,6136,1242,425
27186,6666,5627,5608,5961,1058,334
26059,6793,6330,5770,6509,1023,179
25300,6476,5809,5503,5983,973,174
25097,6231,5154,5198,5344,1033,190
25301,6102,4984,5019,5258,1083,274
26120,5541,4308,4578,4625,963,317
26456,4958,3684,3996,3917,962,233
28193,4708,4223,3748,4603,960,380
30687,3436,2384,2548,2747,888,363
32755,2805,1139,2081,1567,724,428
34373,2758,1112,1963,1573,795,461
35834,2452,918,1670,1265,782,511
37233,2020,840,1263,958,757,434
38644,1780,767,956,946,824,641
39724,1397,617,783,463,614,511
40319,1749,757,1232,600,517,436
40299,2475,903,2010,731,465,269
39256,4710,2551,3582,3011,1128,460
37896,5592,3707,4313,4219,1279,512
38053,5798,4431,4663,5044,1135,613
36720,4992,3784,4348,4316,644,532
34371,4529,3884,3906,4285,623,401
31476,3690,2700,3098,3035,592,335
28976,3116,2160,2770,2364,346,204
27003,2827,1932,2538,2052,289,120
25708,2578,2287,2082,2473,496,186
24807,1863,1243,1384,1450,479,207
24355,1302,401,964,350,338,51
24412,2018,1089,1553,1161,465,72
24989,2054,1306,1754,1383,300,77
25389,1863,1202,1557,1237,306,35
27078,1654,911,1385,971,269,60
29192,1423,916,1141,955,282,39
30796,1033,605,609,535,424,70
32210,642,220,295,61,347,159
33398,516,170,151,30,365,140
34229,430,170,71,9,359,161
34649,450,250,65,9,385,241
34800,486,284,54,17,432,280
34776,548,332,79,11,469,343
34696,623,394,168,25,455,419
34254,658,313,256,26,402,287
33960,875,375,409,68,466,307
35055,1208,622,710,242,498,380
34287,1541,875,968,554,573,321
31937,1962,928,1368,912,594,281
29000,2342,933,1787,1194,555,262
26719,2759,1375,2255,1542,504,167
25319,3271,2028,2764,2193,507,165
24492,3415,2640,2980,2755,435,115
24176,3024,2182,2650,2250,374,68
24583,2986,2317,2734,2383,252,66
26181,2846,2043,2605,2098,241,55
29177,2935,2308,2650,2360,285,52
30389,2669,2270,2449,2314,220,44
31345,2128,1933,1949,1965,179,32
32840,1502,1114,1372,1136,130,22
34503,1067,414,924,413,143,1
35875,1335,670,1110,669,225,1
37044,1348,604,1037,564,311,40
38327,1446,683,1109,539,337,144
39305,1746,798,1384,627,362,171
40209,2470,1092,2028,1293,442,201
40976,3250,1785,2704,1988,546,203
40724,3902,2363,3247,2626,655,263
39744,4217,2824,3493,3141,724,317
38750,4169,3053,3409,3421,760,368
39499,3813,2274,3086,2588,727,314
37916,4294,3241,3502,3550,792,309
34428,4229,3675,3449,3967,780,292
30753,3599,2994,2833,3250,766,256
28026,3828,3309,2980,3586,848,277
26352,3891,3300,3192,3568,699,268
25518,4102,4300,3491,4575,611,275
25115,2984,2017,2542,2131,442,114
25330,3403,2533,3037,2634,366,101
27000,3717,3254,3423,3324,294,70
30430,3590,3322,3057,3342,533,20
31539,3117,1966,2509,2006,608,40
31915,3275,2769,2814,2840,461,71
33331,2849,3496,2399,3550,450,54
35045,1598,852,1299,844,299,76
36684,1492,837,1110,946,382,128
38319,1154,468,874,359,280,109
40237,1341,705,960,589,381,116
41921,1426,763,1049,542,377,221
43360,1477,745,1124,589,353,156
44235,1672,848,1314,710,358,138
43888,2022,910,1558,936,464,190
42517,2430,976,1909,1241,521,265
41010,2840,1484,2287,1771,553,287
41280,3180,1921,2537,2195,643,274
39509,3546,1993,2803,2262,743,269
35910,4238,2751,3335,3070,903,319
31970,4343,2827,3482,3161,861,334
29092,4447,2903,3629,3252,818,349
27437,4861,3488,4041,3775,820,287
26280,4855,3620,4130,3902,725,282
25734,4669,3475,4000,3687,669,212
25828,4432,3175,3753,3373,679,198
27427,4236,2882,3642,3092,594,210
30918,4186,2973,3586,3120,600,147
31914,4042,3004,3464,3151,578,147
32323,3554,3174,3085,3277,469,103
33893,2570,1364,2222,1439,348,75
35800,2974,1704,2479,1830,495,126
37546,3252,2052,2668,2386,584,334
39248,2795,1665,2202,2081,593,416
41118,2265,903,1609,1184,656,338
42543,2508,909,1682,1112,826,503
43639,3126,931,2138,1550,988,715
44105,3653,1249,2578,1952,1075,703
43752,4374,1706,3174,2470,1200,764
42392,5132,2285,3784,3085,1348,800
40710,6050,4010,4337,5072,1713,1062
40998,5354,2856,3964,3830,1390,974
39306,5356,3011,3961,3863,1395,852
35805,5466,3972,4148,4953,1318,981
32008,4537,4198,3264,5239,1273,1041
29273,3175,1512,2502,2047,673,535
27600,3586,2430,2926,2986,660,556
26616,3444,2305,2882,2761,562,456
26211,3562,2053,3030,2221,532,168
26623,4720,3124,3772,3303,948,179
28356,5663,4467,4160,4886,1503,419
31923,5916,4176,4402,5189,1514,1013
33384,5366,3122,4184,4062,1182,940
33323,5280,3356,4180,4036,1100,680
34148,5103,2771,4172,3265,931,494
35434,5769,3395,4691,3909,1078,514
36684,6569,4540,5212,5049,1357,509
37775,6826,4498,5282,5201,1544,703
38985,6682,4027,5017,4878,1665,851
39940,6315,3434,4654,4331,1661,897
40793,6247,3372,4553,4295,1694,923
41332,6148,3204,4456,4087,1692,883
41065,6261,3143,4591,4013,1670,870
40101,6812,3665,5121,4560,1691,895
39141,7553,4916,5731,5904,1822,988
40120,7631,5404,5842,6412,1789,1008
38954,7288,4623,5493,5563,1795,940
36020,7574,5055,5720,6042,1854,987
32608,7448,4888,5724,5851,1724,963
29981,7444,5167,5688,6156,1756,989
28103,6967,4738,5316,5690,1651,952
27028,6327,4058,4764,4849,1563,791
26376,6274,4850,4624,5727,1650,877
26543,5393,4000,4117,4781,1276,781
28222,4648,2933,3460,3441,1188,508
31654,4736,3020,3567,3604,1169,584
33037,4524,2619,3288,3197,1236,578
33484,4639,2475,3270,3296,1369,821
34857,4405,1905,3123,2691,1282,786
36224,4509,1624,3197,2425,1312,801
37268,5097,2438,3424,3380,1673,942
38280,5100,2620,3278,3696,1822,1076
39514,4830,2334,2940,3476,1890,1142
40505,4501,1631,2869,2614,1632,983
41116,4654,1563,3109,2434,1545,871
41464,5567,2275,3960,3170,1607,895
41061,6386,2972,4736,3875,1650,903
40022,7112,3858,5338,4823,1774,965
39012,7557,4591,5675,5632,1882,1041
39627,7629,5077,5670,6192,1959,1115
38731,7559,5287,5599,6400,1960,1113
36630,7825,6052,5753,7115,2072,1063
34040,7977,6289,5827,7463,2150,1174
31764,7763,5798,5574,6985,2189,1187
30094,8039,5738,5911,6892,2128,1154
29028,8357,6181,6150,7373,2207,1192
28369,8582,6591,6301,7817,2281,1226
28156,8547,6553,6274,7750,2273,1197
28601,8452,6388,6216,7580,2236,1192
29729,8292,6080,6099,7244,2193,1164
30687,8038,5521,5934,6676,2104,1155
32285,8117,6180,5818,7445,2299,1265
34335,8045,6018,5806,7275,2239,1257
36169,8145,6208,5911,7479,2234,1271
37585,8165,6115,5894,7366,2271,1251
38440,8286,6307,5979,7570,2307,1263
38921,8359,6387,6065,7648,2294,1261
39146,8439,6518,6143,7778,2296,1260
39029,8494,6545,6207,7807,2287,1262
38847,8571,6664,6288,7928,2283,1264
38445,8528,6566,6265,7824,2263,1258
37843,8466,6443,6194,7702,2272,1259
37650,8510,6572,6205,7843,2305,1271
38486,8645,6847,6294,8132,2351,1285
37791,8614,6818,6256,8112,2358,1294
36190,8594,6938,6206,8249,2388,1311
34048,8508,6901,6093,8230,2415,1329
31670,8353,6673,5961,7992,2392,1319
30177,7796,5247,5705,6406,2091,1159
29114,7193,4471,5270,5599,1923,1128
28169,6661,4440,4604,5690,2057,1250
27686,5108,2712,3247,3988,1861,1276
27798,4202,1537,2556,2758,1646,1221
28349,3734,996,2183,2157,1551,1161
28535,3674,944,2080,2176,1594,1232
29943,3581,901,2151,2027,1430,1206
31660,3598,901,2344,1696,1254,955
33272,4301,1430,3017,2261,1284,831
34463,5343,2669,3988,3490,1355,821
34961,5870,3397,4294,4155,1576,758
35270,6889,5346,5112,6300,1777,954
35487,6751,4795,5278,5662,1473,867
35590,6336,3919,4897,4624,1439,705
35837,6738,4158,5067,4995,1671,837
36170,6749,4515,5034,5384,1715,869
35995,5433,3071,3963,3843,1470,772
35643,4387,2558,2751,3462,1636,904
36445,2771,919,1269,1521,1502,966
35541,1873,812,776,457,1097,931
33033,1528,724,624,351,904,678
29766,1383,652,612,433,771,727
27335,1135,629,694,419,441,540
25806,940,311,479,263,461,48
24934,1306,553,640,292,666,261
24496,1848,799,1398,840,450,971
24776,1526,780,1246,608,280,172
26429,1910,1008,1530,1062,380,54
29820,2364,1236,1846,1372,518,136
31132,2655,1290,2021,1527,634,237
31299,2904,1522,2136,1815,768,293
32151,2957,1510,2100,1921,857,411
32767,2644,860,1886,1277,758,512
33209,2684,1016,1762,1556,922,540
33538,2352,858,1363,1119,989,669
33858,2112,850,1059,924,1053,855
34009,1608,840,741,412,867,766
33991,1233,612,607,142,626,470
34114,1312,829,811,356,501,483
34135,1281,844,798,593,483,268
33877,1248,703,802,461,446,242
33666,1489,770,1042,564,447,206
34895,1961,911,1290,940,671,288
33955,2407,936,1646,1262,761,551
31192,2555,932,2090,1151,465,400
28051,3171,1781,2652,2181,519,400
25933,3094,1826,2484,2158,610,332
24670,3212,1976,2588,2405,624,429
23910,3015,1679,2519,2102,496,423
23652,2843,1543,2399,1842,444,299
24014,2643,1338,2204,1538,439,200
25871,2646,1350,2194,1505,452,155
29489,2754,1517,2271,1680,483,163
30385,2769,1690,2149,1932,620,242
30692,2192,1324,1525,1693,667,369
31627,1277,621,945,495,332,284
32844,1085,509,886,351,199,158
33922,1154,625,945,521,209,104
34921,950,489,767,378,183,111
36362,980,599,754,448,226,164
37618,813,446,616,279,197,167
38941,761,355,602,216,159,139
39932,872,411,682,292,190,119
40064,1040,548,765,401,275,147
39130,1252,710,901,510,351,200
37756,1537,876,1205,780,332,246
38031,1985,936,1662,1024,323,145
36532,2960,1469,2550,1578,410,109
33272,4527,2951,3886,3107,641,156
29731,5576,4413,4881,4586,695,173
27092,5910,5622,5122,5718,788,96
25621,5955,5152,5160,5253,795,101
24736,6300,5552,5403,5650,897,98
24335,6775,6602,5778,6711,997,109
24630,6904,6898,5828,6983,1076,85
26234,6892,6588,5791,6709,1101,121
29693,6972,6506,5900,6639,1072,133
30680,6926,6493,5879,6608,1047,115
31129,6858,6722,5979,6837,879,115
32130,6269,5765,5416,5792,853,27
33306,6459,6347,5514,6380,945,33
34313,6451,6776,5486,6801,965,25
35338,5941,5878,5086,5880,855,2
36702,5276,4636,4614,4641,662,5
38020,4592,3748,4055,3765,537,17
39360,4149,3212,3659,3252,490,40
40595,3941,2759,3453,2804,488,45
40940,4266,2861,3705,2901,561,40
40197,5101,3705,4403,3798,698,93
38584,5832,4921,5027,5080,805,159
38611,5846,4724,4888,4948,958,224
37050,6022,4437,4939,4795,1083,358
33551,6915,6150,5518,6540,1397,390
29873,7630,7340,6086,7762,1544,422
27305,7782,7524,6245,7978,1537,454
25755,7895,8034,6334,8463,1561,429
24808,7814,8019,6344,8397,1470,378
24337,7707,8108,6360,8378,1347,270
24582,7585,8129,6323,8279,1262,150
26187,7504,7878,6320,8012,1184,134
29552,7290,7246,6153,7367,1137,121
30531,7222,7012,6073,7135,1149,123
31103,7099,7090,6044,7220,1055,130
32310,6323,6136,5263,6224,1060,88
33743,6005,5275,5031,5381,974,106
34865,5166,4484,4287,4611,879,127
35949,4070,3658,3335,3783,735,125
37467,2940,2362,2282,2477,658,115
38982,2191,1105,1620,1273,571,168
40405,2324,1041,1642,1292,682,251
41552,2425,928,1715,1137,710,356
41643,2829,1077,2029,1526,800,449
40508,3012,1197,2096,1744,916,547
38938,3172,1391,2070,2136,1102,745
39326,3055,1083,1964,1791,1091,708
37976,3534,1237,2589,1820,945,583
34765,4130,1567,3119,2146,1011,579
31202,5048,3471,3808,4219,1240,748
28434,4541,3728,3525,4409,1016,681
26849,3581,2302,2803,2766,778,464
25896,3719,1643,2858,1971,861,328
25381,5281,4517,3864,5016,1417,499
25566,4839,2974,3559,3458,1280,484
27263,5358,2849,3860,3458,1498,609
30496,6361,4234,4710,5104,1651,870
31663,5995,4012,4691,4686,1304,674
32333,5813,4359,4840,4737,973,378
33468,5864,4864,4879,4999,985,135
34706,6253,5219,5138,5396,1115,177
35481,6572,5500,5675,5755,897,255
35531,6168,5524,5377,5580,791,56
35553,5668,5026,4691,5053,977,27
35306,5216,4455,4204,4767,1012,312
34960,4274,2954,3391,3231,883,277
34634,4115,2801,3176,2979,939,178
34142,4235,2611,3354,2945,881,334
33140,4160,2674,3372,2983,788,309
32318,3895,2944,3200,3121,695,177
33040,3432,2794,2774,3153,658,359
32414,2581,1128,2114,1500,467,372
30447,2624,1100,2156,1516,468,416
28017,2570,1161,2054,1584,516,423
25940,2250,936,1797,1293,453,400
24690,1998,930,1535,1010,463,316
23843,1887,904,1370,809,517,356
23395,1845,867,1132,994,713,501
23354,1370,590,872,516,498,453
23873,1283,559,809,467,474,340
24917,1409,586,893,528,516,379
25664,1517,630,986,634,531,431
27163,1414,585,855,744,559,511
28560,975,480,480,264,495,284
29493,1016,395,445,236,571,405
29873,1145,395,412,355,733,670
30114,941,407,204,118,737,459
30326,1044,622,174,35,870,657
30759,1095,774,180,14,915,788
31386,1029,730,107,6,922,736
32153,963,776,88,7,875,783
32728,820,675,90,1,730,676
32676,726,556,168,29,558,585
32015,736,487,458,143,278,344
32476,901,320,731,283,170,37
31743,1627,692,1428,636,199,56
29868,2680,1404,2388,1498,292,94
27600,3547,2444,3215,2530,332,86
25478,3879,2843,3463,2896,416,53
24093,4018,2902,3607,2963,411,61
23228,4115,3154,3734,3184,381,30
22794,4082,3402,3706,3418,376,16
22548,3692,3192,3427,3207,265,15
22742,3156,2735,2868,2739,288,4
23195,2429,1845,2291,1854,138,9
23518,1973,1313,1908,1318,65,5
25237,1717,1515,1641,1522,76,7
27064,1150,1282,1073,1283,77,1
28527,614,316,547,315,67,1
29839,698,184,667,183,31,1
31221,980,377,926,376,54,1
32709,1481,1024,1355,1025,126,1
34269,1580,1016,1361,1017,219,1
35772,1814,1656,1577,1657,237,1
37231,1643,1300,1433,1301,210,1
37998,1831,1479,1578,1491,253,12
37785,2330,1866,2063,1884,267,18
36815,3030,2127,2679,2146,351,19
36981,4298,3565,3738,3611,560,46
35881,4736,3471,4089,3575,647,104
32924,5365,4446,4719,4591,646,145
29344,5174,4382,4571,4514,603,132
26684,4654,3885,4058,4013,596,128
24930,4133,3107,3472,3276,661,169
24043,3720,2523,3120,2687,600,164
23546,3502,2355,2933,2524,569,169
23835,3267,2128,2829,2297,438,169
25523,3065,2143,2662,2255,403,112
28907,2853,2315,2507,2471,346,156
29791,2112,1317,1778,1416,334,99
30361,1902,833,1608,1023,294,204
31431,2149,1103,1811,1325,338,222
32471,2150,1047,1769,1274,381,227
33358,2312,961,1890,1212,422,251
34078,2569,1087,2048,1420,521,333
34999,2703,1190,2174,1683,529,493
35858,2444,1231,1967,1646,477,415
36866,2072,857,1720,1148,352,294
37838,1901,893,1567,1052,334,264
38226,1621,874,1262,853,359,246
37667,1580,912,1227,805,353,272
36565,1674,924,1357,860,317,213
36930,2145,1155,1877,1364,268,209
35544,2577,1306,2374,1449,203,143
32154,3564,2240,3312,2375,252,135
28633,4433,3277,4153,3471,280,194
26296,4633,3634,4378,3828,255,194
24943,4742,4281,4460,4450,282,169
24154,4422,3951,4140,4133,282,182
23867,4104,3349,3873,3492,231,143
24206,4187,3321,3977,3433,210,112
25949,4756,4043,4496,4154,260,111
29342,4842,3677,4566,3825,276,148
30171,5029,4058,4656,4242,373,184
30711,4579,3479,4235,3763,344,284
31906,3845,2269,3435,2465,410,196
33256,3963,2528,3392,2959,571,431
34487,3231,1868,2570,2424,661,556
35768,2288,917,1650,1069,638,486
37373,2082,892,1425,700,657,530
38957,2284,907,1529,784,755,599
40862,2623,925,1749,1098,874,769
42544,2795,934,1840,1249,955,776
42989,3045,946,2098,1449,947,866
42317,3407,1032,2486,1834,921,802
40821,4185,1998,3185,2881,1000,883
40819,4679,2177,3886,2933,793,756
39388,5787,3373,5001,4082,786,709
35922,7599,6948,6584,7903,1015,955
32049,7833,7854,6647,8821,1186,967
29344,7752,7575,6639,8649,1113,1074
27762,7477,7165,6420,8111,1057,946
26709,7538,7410,6486,8317,1052,907
26258,7417,7256,6477,8162,940,906
26463,7468,7847,6655,8675,813,828
28182,7076,7066,6342,7733,734,667
31480,6737,6064,5957,6673,780,609
32513,6498,5358,5832,6134,666,776
33262,5997,4783,5282,5389,715,606
34606,5123,3300,4208,3943,915,643
36573,4694,2484,3786,3397,908,913
38530,4006,1946,3129,2742,877,796
40660,3304,1153,2406,1925,898,772
43030,2857,892,1952,1326,905,814
45284,2818,936,1790,1217,1028,865
47268,2854,949,1745,1168,1109,1008
48915,3072,952,1836,1487,1236,1114
49194,3195,951,1945,1638,1250,1150
47993,3260,951,1964,1756,1296,1159
45894,3446,951,2125,1918,1321,1169
45568,4068,1205,2983,2238,1085,1033
43796,4989,2024,4054,2910,935,886
39936,6395,3841,5355,4800,1040,959
35717,6972,4824,5811,5845,1161,1021
32687,7126,5269,5918,6413,1208,1144
30662,6665,4515,5472,5528,1193,1013
29285,6733,4676,5537,5805,1196,1129
28480,6331,4333,5270,5406,1061,1073
28428,5852,3843,4940,4722,912,879
29907,5756,4158,4804,5051,952,893
33041,5226,3392,4259,4246,967,854
33909,4593,2360,3666,3223,927,863
34732,4085,1971,3062,2913,1023,942
36474,3175,970,2070,1908,1105,938
38551,2434,921,664,1571,1770,1531
40668,1432,1068,290,75,1142,1143
42735,1272,897,189,105,1083,1002
44982,1154,794,93,62,1061,856
46834,1260,967,101,36,1159,1003
48296,1361,1075,153,36,1208,1111
48870,1450,978,254,86,1196,1064
48381,1623,913,436,157,1187,1070
46552,1908,766,712,311,1196,1077
44724,2297,796,1133,601,1164,1057
44799,2952,938,1793,1149,1159,1051
43153,3985,1111,2938,2089,1047,978
39604,5101,2334,4064,3279,1037,945
35659,5959,3321,4942,4278,1017,957
32794,7378,6156,6122,7304,1256,1148
30798,7380,6048,6196,7144,1184,1096
29473,7517,6465,6339,7545,1178,1080
28627,7499,6792,6376,7879,1123,1087
28453,6774,5761,5887,6674,887,913
29826,6363,5241,5553,5963,810,722
32759,5664,4169,4756,4840,908,671
33579,5136,3144,4199,4003,937,859
34548,4591,2905,3474,3955,1117,1050
36054,3608,1349,2482,2164,1126,815
37850,3548,950,2237,2145,1311,1200
39582,3150,937,1844,1651,1306,1160
41215,2956,940,1906,1106,1050,942
43081,3466,949,2478,1476,988,900
44711,4219,1364,3146,2327,1073,963
46093,4417,1530,3329,2494,1088,964
47070,4292,1247,3281,2135,1011,888
46711,4534,1490,3456,2450,1078,960
44954,4346,1306,3264,2283,1082,977
42768,4018,1160,2775,2271,1243,1111
42347,3347,950,2165,1490,1182,1056
40987,3388,950,2414,1290,974,882
38319,4687,1460,3794,2277,893,817
35322,6449,3861,5270,4905,1179,1044
32708,6639,4143,5438,5209,1201,1066
30632,6252,3711,5039,4778,1213,1067
29180,6244,3676,5068,4749,1176,1073
28360,6186,3680,5080,4709,1106,1029
27828,5984,3742,4908,4736,1076,994
27982,5285,3108,4313,4016,972,908
28686,4723,2612,3807,3455,916,843
29309,4296,2134,3505,2964,791,830
31559,3744,1816,2961,2629,783,813
34101,2879,867,2096,1283,783,555
36522,3010,920,1861,1376,1149,951
38740,2569,916,1325,819,1244,1140
40472,2160,792,777,528,1383,1246
41967,1786,944,496,224,1290,1168
43271,1760,946,525,174,1235,1120
44237,1919,851,724,221,1195,1072
44622,2283,872,1234,442,1049,938
44039,3000,944,2016,965,984,873
42385,4283,1228,3116,2126,1167,898
40638,4967,1530,3786,2460,1181,930
40621,6120,2832,4703,4182,1417,1350
39559,6035,2857,4528,4108,1507,1251
37453,5938,2432,4529,3797,1409,1365
34800,6138,2832,4696,4153,1442,1321
32046,6218,3007,4646,4406,1572,1399
30180,6043,2937,4383,4466,1660,1529
28782,5216,1751,3997,2977,1219,1226
27865,5304,2356,4063,3435,1241,1079
27330,5301,2418,3786,3586,1515,1168
27292,4816,1550,3473,2876,1343,1326
27616,4522,1711,3359,2916,1163,1205
27930,4193,1893,2925,3041,1268,1148
29975,3597,1025,2261,2119,1336,1094
32272,3630,935,2148,1917,1482,1186
34364,4029,1049,2246,2790,1783,1741
36179,3053,942,1654,1216,1399,1141
37990,3043,943,1674,1105,1369,1190
39500,3047,926,1719,1210,1328,1239
40794,2821,882,1639,1036,1182,1040
41883,3182,920,2034,1271,1148,1057
42630,3583,937,2512,1623,1071,994
42688,4072,1221,2962,2220,1110,999
41859,4205,1148,3208,2031,997,883
40782,4706,1625,3640,2518,1066,893
41300,5331,2272,4170,3351,1161,1079
40361,5374,2367,4230,3379,1144,1012
37686,5555,3031,4127,4240,1428,1209
34329,4896,2029,3514,3170,1382,1141
31815,5085,1768,3795,2911,1290,1143
30186,5928,3209,4291,4640,1637,1431
29145,5074,2253,3636,3642,1438,1389
28738,4270,1541,3128,2540,1142,999
28998,4299,1535,3276,2369,1023,834
30822,5043,2570,3948,3639,1095,1069
34165,4464,2087,3496,2898,968,811
35422,4510,2103,3523,2973,987,870
36245,4312,1744,3377,2545,935,801
37666,4459,1724,3478,2521,981,797
39351,4804,2003,3701,3051,1103,1048
40961,4378,1756,3154,2658,1224,902
42493,4137,1396,2703,2739,1434,1343
43646,3206,939,1960,1459,1246,1060
44732,3051,948,1917,1082,1134,907
45939,3471,947,2342,1272,1129,953
46749,4291,971,3056,2051,1235,1080
46563,4834,1349,3582,2382,1252,1033
45332,6106,2671,4490,3988,1616,1317
44100,6950,3775,5251,5380,1699,1605
44410,6848,4143,5193,5558,1655,1415
42851,6178,3064,4865,4274,1313,1210
39476,6417,3327,4980,4405,1437,1078
35357,7089,4263,5693,5714,1396,1451
32274,6393,3589,5232,4633,1161,1044
30465,6350,4097,5194,5195,1156,1098
29243,6280,4295,5403,5368,877,1073
28552,5787,4164,4963,4898,824,734
28681,5619,3211,4428,3895,1191,684
30362,6679,3929,5030,5119,1649,1190
33855,6962,3715,5508,5241,1454,1526
34851,6774,4241,5610,5501,1164,1260
35550,6653,4454,5482,5385,1171,931
36909,6701,4139,5377,5197,1324,1058
38707,6955,4141,5565,5410,1390,1269
40953,6526,3470,5231,4635,1295,1165
42688,6180,3212,4884,4360,1296,1148
44416,5655,2671,4318,3769,1337,1098
45726,5286,2058,3963,3169,1323,1111
46825,5282,1892,3927,3040,1355,1148
47446,5505,1906,4208,3069,1297,1163
47024,5988,2378,4690,3498,1298,1120
46013,6611,3184,5213,4401,1398,1217
44642,7149,4032,5682,5319,1467,1287
44490,7635,5009,6113,6361,1522,1352
43205,7720,5390,6245,6701,1475,1311
39676,7788,5885,6290,7164,1498,1279
35486,7788,6160,6255,7443,1533,1283
32757,7581,5923,6154,7200,1427,1277
30779,7267,5389,6000,6478,1267,1089
29625,6970,4931,5795,5923,1175,992
28955,6721,4631,5620,5561,1101,930
29029,6307,4096,5302,4953,1005,857
30680,6097,3914,5145,4720,952,806
33859,5981,4082,5074,4865,907,783
34838,5432,3395,4665,4070,767,675
35721,5222,3254,4492,3845,730,591
37573,4860,2469,4071,2939,789,470
39425,5729,3517,4729,4312,1000,795
40929,5028,2932,4066,3738,962,806
42411,4096,2112,3169,2837,927,725
44125,3366,1438,2402,2123,964,685
45776,2963,922,2008,1652,955,730
47407,2754,892,1893,1282,861,639
48860,3012,928,2141,1349,871,627
49168,3476,947,2582,1579,894,658
48307,4188,1401,3253,2130,935,729
46606,4931,2074,3973,2865,958,791
46235,5646,3234,4778,4159,868,925
44612,5655,3406,4783,4038,872,632
40801,6326,4065,5353,4858,973,793
36573,6895,5177,5742,6125,1153,948
33483,7214,5943,6028,7022,1186,1079
31445,6367,4768,5249,5712,1118,944
29870,5323,3622,4289,4609,1034,987
29056,4348,2784,3310,3628,1038,844
29080,3654,1724,2738,2446,916,722
30734,3752,2094,2786,2954,966,860
33944,3349,1744,2569,2395,780,651
35337,3162,1484,2563,2062,599,578
36609,2965,1501,2469,1891,496,390
38641,2788,1142,2238,1393,550,251
40990,3294,1562,2538,2099,756,537
43310,2912,1424,2056,2125,856,701
45793,2019,795,1266,1066,753,578
48374,1705,739,932,752,773,534
50587,1575,734,754,525,821,620
52321,1526,731,703,387,823,570
53440,1871,824,879,607,992,786
53159,2134,882,1053,845,1081,889
51321,2425,912,1500,961,925,752
48829,2981,948,2287,1030,694,518
48283,4930,2381,4017,3177,913,796
46374,5375,2796,4462,3499,913,703
42420,5920,3952,4900,4773,1020,821
38016,5275,3081,4340,3829,935,748
34710,5355,3199,4354,3984,1001,785
32560,5292,3412,4428,4369,864,957
31048,4717,3280,3940,3974,777,694
30134,4277,2399,3574,2904,703,505
30033,4753,3445,4107,4236,646,791
31523,3996,2637,3435,3075,561,438
34610,3899,2351,3276,2779,623,428
35773,4086,2404,3427,2960,659,556
37022,3960,2208,3340,2772,620,564
39136,3751,1711,3088,2103,663,392
41671,4296,2029,3496,2603,800,574
44121,4412,2412,3461,3142,951,730
46473,3680,1931,2793,2772,887,841
48874,2641,1064,1940,1688,701,624
51082,2096,895,1559,871,537,384
52892,2343,907,1740,919,603,347
54029,3155,970,2348,1571,807,601
53728,3565,1120,2630,1791,935,671
51334,4021,1519,3000,2475,1021,956
48807,3791,1564,2787,2448,1004,884
47622,3712,1482,2817,2320,895,838
45493,3935,1535,3119,2251,816,716
41864,4765,2093,3795,2791,970,698
38174,5830,2881,4644,3812,1186,931
34881,6368,3584,5189,4699,1179,1115
32744,6276,3876,5201,4881,1075,1005
31226,5837,3404,4791,4182,1046,778
30087,6138,3790,5063,4761,1075,971
29454,6133,4087,5078,5012,1055,925
29679,5882,3722,4788,4535,1094,813
30381,5746,3127,4763,4010,983,883
31252,5798,3258,4788,4087,1010,829
33670,5812,3210,4805,4074,1007,864
36774,5402,2580,4290,3327,1112,747
39855,5847,3239,4439,4458,1408,1219
43064,4508,1993,3171,3125,1337,1132
45674,3443,1008,2268,2127,1175,1119
48063,2667,908,1524,1396,1143,952
50093,2235,881,1054,840,1181,917
51484,2133,822,1008,604,1125,948
52060,2371,860,1208,748,1163,1006
51603,2648,898,1427,1002,1221,1060
49971,2958,919,1677,1371,1281,1212
47630,3226,931,1863,1718,1363,1255
46688,3588,951,2247,1788,1341,1065
45007,4301,999,2880,2032,1421,1033
41931,5560,1896,4044,3317,1516,1421
38829,6009,2893,4568,4249,1441,1356
35882,5901,2853,4642,3942,1259,1089
33647,6297,3751,4976,4966,1321,1215
31794,5798,3184,4663,4201,1135,1017
30537,5758,3241,4696,4177,1062,936
29661,5716,3448,4706,4381,1010,933
29514,5381,3035,4423,3770,958,735
29725,5862,3485,4915,4328,947,843
29925,5667,3327,4565,4059,1102,732
31665,5335,2597,4393,3500,942,903
33676,4901,2545,4232,3259,669,714
35773,4666,2511,3772,2968,894,457
37858,4865,2193,3616,3008,1249,815
40163,4691,1871,3342,3325,1349,1454
42500,3170,936,2182,1850,988,1047
44375,2228,920,1286,924,942,631
45920,2045,913,937,651,1108,916
47200,1834,905,797,363,1037,923
47627,1777,902,866,373,911,835
46548,1945,904,985,632,960,919
44891,2127,926,1150,1073,977,1020
44507,2237,904,1555,1078,682,704
43123,2552,928,2030,1219,522,439
39873,3214,1166,2648,1473,566,307
35902,4323,2025,3709,2554,614,529
32743,4651,3067,3912,3687,739,620
30879,3952,2357,3234,3066,718,709
29668,3334,1564,2491,2219,843,655
29000,3222,1290,2391,2026,831,736
29155,3276,1761,2524,2641,752,880
30752,2969,2052,2612,2786,357,734
33824,2591,1976,2264,2276,327,300
35155,2579,1741,2214,2086,365,345
36768,2540,1402,2123,1723,417,321
39112,2569,1348,2104,1704,465,356
41759,2440,1041,1976,1357,464,316
44375,2554,1010,2045,1324,509,314
46811,2892,994,2360,1393,532,399
49515,3500,1242,2895,1736,605,494
51512,4251,2181,3343,2954,908,773
52766,3785,2175,3001,3087,784,912
53049,2957,942,2343,1249,614,321
51797,4261,1808,3265,2439,996,631
49336,5036,3090,3966,4369,1070,1279
46985,4044,1806,3079,2897,965,1091
45823,3468,1932,2549,2820,919,888
43172,2863,1255,2296,1895,567,640
39092,2859,1402,2336,1750,523,348
35009,3031,1457,2554,1831,477,374
31822,3510,1833,3030,2188,480,355
29881,4106,2246,3384,2579,722,333
28722,5100,3468,4028,4286,1072,818
27704,4550,4378,3535,5489,1015,1111
27771,2464,930,1996,1044,468,305
29313,3338,1563,2749,1921,589,358
32342,3776,2687,2952,3243,824,556
33405,3300,3638,2660,4783,640,1145
34075,1708,892,1493,817,215,143
35283,2128,920,1752,1065,376,145
36630,2798,1493,2063,1840,735,347
37778,3167,1980,2549,2930,618,950
38537,2224,1400,1675,1775,549,375
39174,2034,913,1380,1095,654,409
39372,2350,934,1626,898,724,426
39369,3214,997,2176,1856,1038,859
38798,3077,926,1932,1576,1145,733
37737,3279,943,2105,1624,1174,939
36598,3041,942,2042,1586,999,922
36258,2502,931,1581,1568,921,667
37154,1839,906,1131,981,708,615
36464,1260,798,730,590,530,383
33828,970,557,526,347,444,210
30510,874,551,499,300,375,251
28160,788,260,467,181,321,79
26817,1141,707,632,423,509,320
25938,1090,502,701,247,389,255
25581,1179,738,776,581,403,340
25897,867,337,451,186,416,151
27577,810,312,283,56,527,256
30731,850,479,203,41,647,438
31772,784,525,241,16,543,541
32539,567,250,187,7,380,243
33973,534,192,164,9,370,183
35719,476,179,290,22,186,157
37224,538,70,394,16,144,54
38727,566,63,415,40,151,23
40400,445,66,307,17,138,49
41856,462,83,268,14,194,69
43044,623,218,265,40,358,178
44016,833,451,285,112,548,339
44127,886,636,439,204,447,493
43088,892,479,556,286,336,193
41458,1044,546,735,416,309,130
41122,1189,545,888,464,301,81
39783,1470,689,1161,553,309,136
36425,1997,938,1673,1166,324,233
32502,2085,970,1651,1120,434,150
29509,2453,1102,2161,1439,292,337
27736,2546,1615,2257,1777,289,162
26509,2590,1759,2205,1953,385,194
25985,2514,1434,2143,1713,371,279
26104,2331,1110,2020,1312,311,202
27609,2544,1292,2213,1467,331,175
30681,2659,1308,1815,1474,844,166
31867,2786,924,1932,1376,854,801
33106,2429,909,1654,1462,775,752
34902,1986,938,1148,933,838,483
36527,2212,929,1266,720,946,619
37528,2978,934,1451,1626,1527,1237
38312,2824,937,1260,1251,1564,1219
38881,2750,913,1351,1015,1399,1179
38974,2569,860,1582,577,987,769
38949,3606,894,2109,1866,1497,1307
39097,3188,891,1972,1304,1216,1197
38852,2996,888,1916,1084,1080,833
38033,3447,881,1482,2385,1965,1526
37520,2507,891,963,818,1544,1559
38304,2118,821,842,656,1276,1118
37521,1861,668,676,644,1185,1027
34957,1666,687,868,558,798,1222
31720,1283,681,956,576,327,609
29374,1142,661,685,895,457,354
27916,776,520,630,577,146,352
26699,471,78,212,61,259,17
25916,660,425,344,87,316,365
25944,564,187,339,67,225,120
27467,514,145,243,82,271,63
30613,538,369,433,83,105,286
31674,372,79,342,53,30,26
32361,341,134,333,133,8,1
33612,321,166,315,135,6,31
35116,299,113,275,79,24,34
36469,271,56,256,54,15,2
37541,257,33,240,30,17,3
38814,313,63,302,46,11,17
39818,351,50,253,23,98,27
40506,462,94,312,37,150,57
40892,768,374,532,146,236,228
40579,935,353,671,218,264,135
39183,1374,594,1073,397,301,197
37754,1868,922,1433,1091,435,338
37446,1671,926,1283,730,388,290
36411,1679,888,1164,871,515,270
34271,1681,881,1174,574,507,307
31456,2064,933,1451,812,613,384
29085,2525,932,1796,1475,729,543
27509,2413,1086,1873,1655,540,569
26412,1884,971,1473,1243,411,272
25703,1450,731,1231,593,219,138
25494,1362,681,1142,605,220,76
25819,1334,598,1128,493,206,105
26661,1445,638,1200,537,245,101
27458,1658,853,1361,873,297,194
29340,1539,848,1322,682,217,166
31326,1538,851,1318,805,220,112
32968,1496,868,1239,776,257,112
34254,1482,867,1197,697,285,170
35188,1496,857,1177,825,319,248
35986,1261,585,936,452,325,133
36575,1303,591,910,417,393,174
37102,1400,669,996,437,404,232
37444,1439,677,940,470,499,207
37122,1500,876,983,533,517,356
36407,1305,632,845,381,460,251
35309,1305,671,858,409,447,262
35537,1285,745,878,503,407,242
34915,1191,563,852,404,339,159
33122,1329,793,1008,623,321,170
30721,1109,602,847,462,262,140
28257,928,435,605,322,323,113
26526,913,509,550,261,363,248
25371,857,536,447,294,410,242
24630,746,299,337,157,409,142
24239,735,491,266,177,469,314
24239,636,350,243,100,393,250
24322,535,206,247,72,288,134
24924,537,267,271,94,266,173
27164,451,256,138,112,313,144
29341,376,102,136,12,240,90
31202,422,79,264,18,158,61
32784,543,64,361,34,182,30
34308,531,66,359,31,172,35
35539,417,57,299,38,118,19
36641,497,134,353,94,144,40
37730,610,269,400,189,210,80
38559,695,342,509,236,186,106
38976,799,365,645,266,154,99
38555,1018,529,864,421,154,108
37497,1356,866,1143,759,213,116
37432,1557,1168,1284,1297,273,129
36940,1370,829,1135,710,235,128
34249,1588,891,1237,955,351,162
30628,1513,836,1240,774,273,165
27884,1580,1085,1218,1241,362,156
26163,1199,684,834,868,365,184
25189,1039,681,773,551,266,196
24727,828,382,713,327,115,55
24996,1000,787,904,895,96,108
26624,818,424,795,387,23,37
29525,838,351,783,350,55,1
31137,1061,775,932,791,129,16
32470,745,762,655,770,90,8
34431,340,66,328,65,12,1
36616,445,114,383,113,62,1
38424,581,155,383,151,198,4
40068,594,81,453,42,141,39
41680,871,292,644,199,227,93
42849,982,267,824,163,158,104
43867,1403,858,1183,698,220,160
44372,1338,733,1088,590,250,143
43911,1312,668,938,522,374,146
42497,1378,866,847,564,531,370
40928,1429,871,690,737,739,623
40832,1264,877,607,388,657,684
39421,992,645,511,185,481,460
35843,907,449,531,141,376,308
31956,1032,565,674,261,358,304
29086,1031,658,760,337,271,321
27445,858,334,623,196,235,138
26343,831,393,584,131,247,262
25823,806,160,477,92,329,68
25970,1143,458,771,177,372,281
27625,1210,611,851,299,359,312
30780,997,371,669,183,328,188
31940,887,379,681,112,206,267
32596,666,166,483,94,183,72
33823,465,30,288,14,177,16
35295,321,27,143,2,178,25
35950,354,40,134,1,220,39
36722,355,37,214,1,141,36
37740,335,29,200,1,135,28
38628,329,20,77,5,252,15
39311,517,418,147,2,370,420
40115,436,175,86,8,350,167
39960,475,236,109,1,366,235
39281,462,304,129,1,333,303
38453,329,122,61,4,268,118
38472,313,144,165,1,148,143
37706,317,2,300,1,17,1
34648,460,63,398,62,62,1
30955,651,134,474,132,177,2
28222,966,268,739,214,227,54
26530,1505,815,1186,657,319,158
25534,1846,885,1497,969,349,204
25233,1872,908,1553,949,319,174
25446,2152,988,1805,1193,347,205
26968,2415,1217,2037,1470,378,253
29934,2557,1659,2188,1976,369,317
31189,2119,1413,1867,1593,252,180
32275,1598,992,1413,1058,185,66
33967,1224,776,992,760,232,68
36162,792,169,563,135,229,34
38340,812,256,517,150,295,106
40246,597,323,292,128,305,195
42196,216,40,47,8,169,32
44045,164,15,27,1,137,14
45816,177,24,22,1,155,23
47067,232,87,30,1,202,86
47267,292,111,52,1,240,110
46064,430,117,124,1,306,116
44108,684,231,392,108,292,123
42827,884,270,766,248,118,22
41169,1280,609,1198,576,82,33
37452,1821,965,1624,1043,197,78
33176,2389,1197,2099,1366,290,169
29972,3023,1799,2706,2097,317,298
27980,3177,2059,2822,2318,355,259
26714,3244,1876,2876,2122,368,246
26038,3575,2174,3233,2473,342,299
26053,3740,2860,3445,3156,295,296
27572,3318,2494,3097,2700,221,206
30428,3091,2034,2834,2172,257,138
31735,3105,1980,2857,2151,248,171
33196,2964,2437,2777,2641,187,204
35396,2145,1321,2018,1388,127,67
37999,1927,948,1827,994,100,46
40457,2118,1424,2005,1476,113,52
42716,1844,963,1758,1005,86,42
45157,2071,1185,1920,1232,151,47
47209,2288,1218,2024,1316,264,98
48846,2569,1348,2246,1540,323,192
49940,2836,1527,2452,1752,384,225
49728,3156,1728,2662,2002,494,274
48134,3543,1876,3000,2267,543,391
45826,4066,2413,3482,2895,584,482
44645,4559,3167,3930,3726,629,559
43063,4610,2537,3965,2958,645,421
39157,5661,3524,4857,4132,804,608
34996,6085,4021,5135,4707,950,686
31809,6535,4668,5505,5456,1030,788
29667,6988,5776,5906,6660,1082,884
28328,6868,5755,5705,6608,1163,853
27486,6978,6067,5740,7046,1238,979
27398,6930,6033,5708,7034,1222,1001
28800,6863,5659,5722,6601,1141,942
31496,6769,5065,5761,5927,1008,862
32882,6627,4774,5686,5558,941,784
34623,6515,4631,5644,5400,871,769
36921,6267,4165,5391,4838,876,673
39544,6266,3912,5404,4595,862,683
41761,6474,4190,5556,4919,918,729
43788,6467,4327,5485,5104,982,777
45722,6312,3974,5317,4746,995,772
47435,6373,3929,5330,4749,1043,820
48818,6495,3994,5408,4851,1087,857
49612,6774,4259,5585,5208,1189,949
49179,6896,4228,5628,5234,1268,1006
47188,7187,4523,5825,5662,1362,1139
44563,7454,5026,6045,6279,1409,1253
42998,7489,5338,5991,6595,1498,1257
41793,7335,4601,5971,5786,1364,1185
38799,7631,5123,6167,6362,1464,1239
35510,7978,5704,6420,7024,1558,1320
32495,8004,5872,6382,7230,1622,1358
30409,8006,5912,6439,7286,1567,1374
28952,7812,5755,6270,7019,1542,1264
28019,7736,5819,6184,7126,1552,1307
27524,7417,5529,5944,6759,1473,1230
27688,7223,5308,5788,6452,1435,1144
28136,6753,4361,5538,5382,1215,1021
29149,6827,4719,5705,5678,1122,959
31612,6415,4183,5424,4994,991,811
34521,6184,3650,5118,4359,1066,709
37531,6087,3348,5035,4178,1052,830
39874,5864,3542,4755,4438,1109,896
41744,5013,2900,3927,3836,1086,936
43278,4028,1964,2912,2821,1116,857
44860,3323,1044,2237,1854,1086,810
46059,3279,920,2222,1748,1057,905
46905,3431,1034,2370,1910,1061,876
46731,3662,1080,2596,1890,1066,810
45501,4198,1287,3178,2158,1020,871
43466,5086,2183,4025,3170,1061,987
42224,5754,3117,4642,4136,1112,1019
41045,6004,3026,4924,3944,1080,918
38355,6754,3839,5561,4884,1193,1045
35373,7196,4527,5931,5644,1265,1117
32319,7018,4627,5711,5739,1307,1112
30286,6695,4091,5453,5104,1242,1013
28787,6474,3913,5160,4868,1314,955
27732,6167,3574,4933,4590,1234,1016
26945,5777,3848,4477,4831,1300,983
26668,4353,2613,3120,3534,1233,921
26496,3272,1898,2697,2757,575,859
27169,2210,1818,1779,2075,431,257
29882,1599,776,1217,932,382,156
33127,1674,838,1276,795,398,197
36093,1777,896,1338,1079,439,338
38850,1373,864,989,701,384,229
41255,1112,513,756,341,356,172
43398,1021,356,678,206,343,150
45080,1368,660,912,370,456,290
46406,1571,800,1094,482,477,318
47277,1754,891,1285,573,469,318
47455,2096,948,1556,927,540,358
46772,2249,950,1650,1091,599,388
44908,2331,952,1739,1193,592,411
44042,2508,1059,1918,1510,590,451
42616,2480,1015,1942,1371,538,356
39017,2737,1165,2187,1514,550,349
34805,3048,1585,2486,1987,562,402
31563,2913,1418,2440,1729,473,311
29428,2821,1413,2332,1653,489,240
28125,2747,1341,2282,1682,465,341
27459,2387,1158,1990,1413,397,255
27594,2106,1059,1830,1284,276,225
29177,1785,909,1647,1014,138,105
31894,1639,1079,1561,1103,78,24
33291,1375,903,1322,911,53,8
35081,1180,907,1156,908,24,1
37436,956,573,919,574,37,1
40340,941,671,929,672,12,1
43187,841,870,814,871,27,1
45744,700,498,662,492,38,6
48131,650,272,586,269,64,3
49937,791,342,669,325,122,17
51490,961,420,781,371,180,49
52332,1145,731,885,605,260,131
52301,1179,754,916,608,263,146
50943,1152,709,939,550,213,159
48872,1216,756,997,655,219,101
47557,1405,862,1103,878,302,96
45611,1498,894,1235,763,263,131
41384,1834,1013,1612,1163,222,150
36761,2203,1482,1943,1608,260,126
33215,2526,1601,2261,1766,265,165
30896,2885,1818,2544,1990,341,172
29387,3314,2242,2888,2552,426,310
28437,3150,2174,2698,2472,452,298
28312,2804,2094,2433,2402,371,308
29715,2289,1434,1896,1586,393,152
32325,2557,1464,2160,1680,397,216
33750,2730,1315,2292,1566,438,251
35359,2961,1419,2649,1667,312,248
37742,3038,1413,2662,1561,376,148
40502,3959,3027,3650,3440,309,413
43333,2843,1878,2657,1950,186,72
46271,2702,1639,2483,1712,219,73
49153,2925,1800,2647,1956,278,156
51488,3058,1703,2639,1902,419,199
53427,3233,1444,2661,1731,572,287
54546,3767,1556,3021,2051,746,495
54301,4173,1817,3339,2473,834,656
52756,4343,2164,3371,2938,972,774
50576,4150,1799,3191,2563,959,764
49086,4589,2213,3434,3145,1155,932
47333,4873,1964,3757,2879,1116,915
43105,5850,2806,4560,3842,1290,1036
38407,6735,3667,5274,4850,1461,1183
34930,7330,4467,5703,5829,1627,1362
32542,7104,4240,5471,5452,1633,1212
31017,7780,5152,5945,6723,1835,1571
30005,7514,5041,5772,6600,1742,1559
29952,7235,5164,5438,6655,1797,1491
31532,7054,4571,5546,6039,1508,1468
34222,6901,4115,5508,5279,1393,1164
35410,7015,4019,5558,5330,1457,1311
37042,6787,3599,5161,4832,1626,1233
39485,6406,2766,4719,4114,1687,1348
42196,6227,2465,4553,3966,1674,1501
44625,5820,2246,4167,3798,1653,1552
46959,5050,1696,3445,3137,1605,1441
49476,4448,1116,2891,2547,1557,1431
51675,4107,954,2648,2213,1459,1366
53356,3991,954,2660,1907,1331,1132
54493,4656,1271,3231,2511,1425,1240
54328,5235,1679,3752,2980,1483,1301
52642,5796,2273,4087,3784,1709,1511
50069,5856,2368,3925,4059,1931,1691
48675,5754,1729,4109,3255,1645,1526
47326,6679,2576,5032,4066,1647,1490
43642,7782,3997,5905,5721,1877,1724
39281,8122,4504,6177,6297,1945,1793
36079,8147,4671,6197,6505,1950,1834
33944,7986,4455,6036,6214,1950,1759
32524,7958,4385,5975,6186,1983,1801
31731,7652,3991,5701,5779,1951,1788
31758,7390,3759,5514,5505,1876,1746
33357,7180,3707,5352,5429,1828,1722
36040,6665,3185,4896,4772,1769,1587
37203,6274,2656,4615,4213,1659,1557
38700,6017,2660,4353,4190,1664,1530
40717,5494,2395,3776,4003,1718,1608
43286,4317,1096,2967,2269,1350,1173
45862,3895,937,2651,1895,1244,1046
48194,3617,923,2291,1968,1326,1188
50933,2813,896,1534,1199,1279,1108
53071,2334,834,1083,755,1251,1057
54842,2245,849,1010,585,1235,1066
55956,2355,903,1104,587,1251,1076
55617,2624,938,1393,733,1231,1105
53803,3035,944,1740,1156,1295,1127
51442,3437,954,2098,1503,1339,1145
50348,4091,954,2676,2055,1415,1200
49026,4877,1358,3451,2529,1426,1171
45457,6016,2052,4517,3312,1499,1260
41258,7315,3621,5610,5234,1705,1613
37887,7590,4320,5857,5900,1733,1580
35706,7501,4315,5792,5858,1709,1543
34172,7290,4012,5639,5463,1651,1451
33059,7104,3801,5436,5247,1668,1446
32957,7066,3624,5341,5044,1725,1420
34343,6896,3323,5275,4816,1621,1493
36878,6519,3351,4860,4810,1659,1459
38143,5908,2542,4299,3930,1609,1388
39930,5648,2206,4134,3641,1514,1435
42402,5138,1755,3653,2909,1485,1154
45390,5339,1847,3751,3286,1588,1439
47928,4788,1341,3298,2629,1490,1288
50416,4622,1258,2990,2576,1632,1318
52710,4461,961,2653,2518,1808,1557
54284,4295,951,2854,1808,1441,1254
55855,5297,1507,3690,2877,1607,1370
56374,5940,2672,4061,4519,1879,1847
55650,5295,1964,3719,3530,1576,1566
53308,5378,1796,3937,2928,1441,1132
50530,6512,2879,4862,4410,1650,1531
49220,6800,3340,5194,4869,1606,1529
47887,6871,3278,5288,4604,1583,1326
44882,7604,4050,5833,5618,1771,1568
41439,7591,3970,5827,5556,1764,1586
38344,7592,4376,5771,6056,1821,1680
35926,6746,3498,5191,5032,1555,1534
34074,6221,3057,4921,4307,1300,1250
32936,6337,3419,5176,4527,1161,1108
32441,6601,3996,5537,5001,1064,1005
32500,6890,5022,5955,6008,935,986
32564,6283,4773,5499,5519,784,746
33044,5569,3620,4839,4238,730,618
35762,5660,3292,4884,3914,776,622
38877,6431,4091,5349,4888,1082,797
42020,6786,4419,5483,5507,1303,1088
44928,6885,4550,5492,5771,1393,1221
47014,6664,4173,5189,5397,1475,1224
48793,6563,3840,5051,5143,1512,1303
50180,6518,3611,4984,4913,1534,1302
51320,6517,3302,4969,4627,1548,1325
51807,6866,3510,5168,4916,1698,1406
51554,7361,3996,5538,5589,1823,1593
49981,7526,4230,5665,5826,1861,1596
47650,7668,4523,5772,6173,1896,1650
46173,7625,4486,5930,6099,1695,1613
44855,7260,4197,5741,5595,1519,1398
41902,7204,4264,5710,5563,1494,1299
38731,7423,4732,5849,6093,1574,1361
35789,7378,4972,5654,6381,1724,1409
33616,7222,4830,5378,6308,1844,1478
32112,7127,4582,5411,6114,1716,1532
31023,6574,3864,5262,5117,1312,1253
30337,6365,3872,5241,4838,1124,966
30131,6763,4852,5519,5796,1244,944
29965,7086,5329,5680,6350,1406,1021
30682,7290,5435,5930,6634,1360,1199
33525,6924,4680,5685,5673,1239,993
36558,6979,4561,5598,5606,1381,1045
39508,7058,4396,5611,5593,1447,1197
41922,6883,4073,5397,5265,1486,1192
44152,6671,3673,5179,4897,1492,1224
46199,6332,3221,4812,4443,1520,1222
47759,6100,2864,4546,4096,1554,1232
49041,5792,2341,4308,3585,1484,1244
49815,5586,2141,4131,3330,1455,1189
49739,5671,2283,4150,3524,1521,1241
48270,5664,2188,4210,3389,1454,1201
46270,5959,2667,4584,3948,1375,1281
44815,6236,3696,4930,4974,1306,1278
43804,5826,3588,4611,4730,1215,1142
41068,5403,2744,4256,3644,1147,900
37921,5915,2934,4683,3924,1232,990
35034,6442,3442,5109,4587,1333,1145
33120,6600,3719,5281,4867,1319,1148
31643,6520,3943,5228,5059,1292,1116
30690,6340,3999,5123,5024,1217,1025
30312,5941,3676,4857,4612,1084,936
30528,5190,2860,4259,3627,931,767
30511,4739,2634,3847,3361,892,727
31170,4135,2136,3343,2794,792,658
33794,3595,1511,2862,2019,733,508
37448,3458,1138,2589,1608,869,470
41167,3821,1669,2545,2665,1276,996
44568,2552,917,1363,1584,1189,1092
47388,1413,790,563,336,850,705
49927,1063,611,339,155,724,476
52046,1092,583,362,101,730,482
53613,1273,598,539,109,734,489
54547,1741,845,925,202,816,643
54713,2254,960,1473,472,781,597
53499,3001,962,2141,1014,860,662
51318,3620,961,2700,1603,920,751
49748,4118,1431,3134,2273,984,842
48284,4266,1372,3326,2041,940,669
44098,5277,2359,4076,3356,1201,997
38961,5367,2510,3974,3506,1393,996
35211,5326,2165,4059,3371,1267,1206
32953,5195,2378,4049,3405,1146,1027
31503,5059,2318,3891,3242,1168,924
30823,5290,2629,4086,3610,1204,981
30828,5568,3142,4392,4202,1176,1060
32452,5618,3420,4621,4374,997,954
35008,5418,3308,4545,4043,873,735
36653,5226,2933,4438,3682,788,749
38839,5136,3060,4378,3722,758,662
41513,4548,2405,3747,2954,801,549
44711,4288,2421,3435,3132,853,711
47816,3295,1759,2539,2438,756,679
50659,2193,949,1558,1348,635,528
53661,1451,859,838,511,613,356
56075,1332,754,614,263,718,491
58157,1293,739,524,167,769,589
59480,1403,722,547,219,856,641
59289,1627,798,705,314,922,726
57814,1975,902,967,603,1008,829
55380,2311,952,1245,951,1066,838
53527,2761,952,1770,1278,991,868
51455,3354,953,2291,1673,1063,755
47277,4299,1309,3177,2210,1122,901
42780,5209,1964,4008,2940,1201,976
39187,5843,2652,4606,3750,1237,1098
36582,5892,2927,4718,3999,1174,1072
34881,5902,3271,4751,4299,1151,1028
33550,5871,3380,4713,4354,1158,974
33086,6149,3983,4980,5049,1169,1066
34187,6163,4225,5004,5216,1159,991
36379,5666,3527,4631,4393,1035,866
37340,5057,2694,4187,3430,870,736
38700,4845,3074,3986,3859,859,785
40260,4099,1943,3272,2459,827,516
42506,4346,1904,3438,2530,908,626
44692,4743,2239,3709,2999,1034,760
46728,4875,2272,3720,3173,1155,901
48989,4883,2173,3561,3166,1322,993
51078,5096,2097,3621,3366,1475,1269
53240,4967,1695,3438,2878,1529,1183
54764,5198,1720,3538,3031,1660,1311
54962,5603,2068,3864,3641,1739,1573
53845,5691,1890,4063,3079,1628,1189
51734,6723,2783,4753,4465,1970,1682
50268,6670,2662,4695,4439,1975,1777
48726,6710,2665,4869,4348,1841,1683
44877,6791,2968,4973,4664,1818,1696
40508,6647,3069,4839,4769,1808,1700
36742,6330,3046,4647,4779,1683,1733
34345,5548,2600,3904,4132,1644,1532
32932,4889,1736,3391,3065,1498,1329
32220,4898,1556,3395,2796,1503,1240
32199,4955,1476,3384,2743,1571,1267
33420,4867,1661,3319,3293,1548,1632
35707,3924,1010,2747,2063,1177,1053
36985,4023,1218,2810,2205,1213,987
38337,4360,1850,2985,3378,1375,1528
39903,3421,1103,2184,2059,1237,956
41726,3425,949,2246,1810,1179,1017
43185,3702,949,2695,1901,1007,993
44016,4368,1713,3314,2752,1054,1039
45068,4590,1876,3565,2905,1025,1029
45954,4543,1948,3444,2932,1099,984
46927,4433,1950,3192,3221,1241,1271
48054,3638,1237,2297,2439,1341,1202
48498,3029,955,1631,1534,1398,1158
47819,2823,954,1384,1178,1439,1216
46195,2629,951,1377,858,1252,1073
44915,2732,953,1753,1018,979,1026
43777,2827,956,2055,1627,772,850
40470,2730,1075,2186,1565,544,490
36454,2939,1305,2241,1615,698,310
33108,3551,1653,2640,2308,911,655
30943,3454,1553,2634,2335,820,782
29514,2956,1596,2612,2241,344,645
28607,2298,1451,2076,1622,222,171
28491,2171,1248,1975,1360,196,112
29621,2339,1486,2155,1636,184,150
31385,2226,1329,2004,1439,222,110
32813,2180,1218,1963,1346,217,128
34716,2128,1186,1863,1276,265,90
36922,2221,961,2000,1086,221,125
39558,2551,1193,2217,1275,334,82
41958,3121,1662,2599,1907,522,245
44280,3085,1527,2473,1887,612,360
46931,2894,1255,2294,1684,600,429
49158,2755,1090,2163,1481,592,391
50992,2891,1172,2356,1695,535,523
52079,2877,1315,2377,1727,500,412
51977,3026,1561,2507,2018,519,457
50391,3011,1549,2490,1950,521,401
47902,3164,1691,2615,2119,549,428
45841,3463,2447,2924,3058,539,611
44262,3509,2340,2985,2861,524,521
41195,3836,2094,3240,2544,596,450
37763,4561,2543,3769,3067,792,524
34752,5264,3056,4313,3782,951,726
32521,5490,3584,4529,4416,961,832
30937,5126,3294,4351,4030,775,736
29922,4987,3743,4250,4478,737,735
29327,4216,2531,3344,3049,872,518
29527,4259,2517,3472,3357,787,840
30007,3917,2078,3247,2537,670,459
30911,4028,2216,3096,2748,932,532
33549,3933,2051,2815,2891,1118,840
37050,3275,951,2358,1543,917,602
40714,3478,1097,2584,1824,894,727
44227,3301,1033,2544,1610,757,577
47276,3292,1165,2426,1688,866,523
49716,3403,1213,2196,2067,1207,854
51796,2828,949,1582,1212,1246,947
53502,2646,950,1399,899,1247,1071
54309,2780,949,1486,1015,1294,1087
54073,3120,950,1832,1220,1288,1078
52493,3768,950,2335,1971,1433,1233
50098,4072,982,2617,2209,1455,1227
48215,4582,1564,3209,3003,1373,1439
46645,4662,1679,3515,2696,1147,1017
43760,5545,2362,4171,3359,1374,997
40528,6544,3238,5044,4674,1500,1436
37566,6553,3701,5196,5103,1357,1402
35142,6127,3431,4827,4501,1300,1070
33481,6231,3557,4744,4793,1487,1236
32303,5910,3097,4250,4381,1660,1284
31539,5308,2312,3785,3773,1523,1461
31301,4628,2091,3587,3332,1041,1241
31144,4088,1804,3407,2390,681,586
31752,4711,2407,3890,3004,821,597
34384,5291,2796,4288,3593,1003,797
37691,5549,2645,4470,3565,1079,920
41001,6012,2925,4805,3959,1207,1034
44498,6216,2802,4818,3832,1398,1030
47675,6984,3324,5300,4668,1684,1344
50368,7230,3404,5464,4904,1766,1500
52238,7180,3251,5439,4740,1741,1489
53226,7053,3096,5310,4616,1743,1520
53706,6854,2890,5131,4413,1723,1523
53381,6688,2740,4971,4221,1717,1481
52009,6645,2710,4950,4223,1695,1513
50011,6602,2815,5063,4334,1539,1519
48731,6540,3405,5060,4885,1480,1480
47683,6231,3347,4853,4692,1378,1345
44530,6074,3214,4821,4435,1253,1221
40616,6074,3117,4875,4191,1199,1074
37243,6487,3667,5085,4762,1402,1095
35278,6850,4150,5306,5451,1544,1301
33824,6231,3963,4825,5433,1406,1470
32970,5557,3754,4385,4906,1172,1152
32851,4699,2773,3693,3659,1006,886
34079,4377,2582,3360,3478,1017,896
36226,3856,2187,3178,3076,678,889
37693,3145,1814,2642,2253,503,439
39880,2745,1448,2171,1800,574,352
42401,2479,924,1894,1215,585,385
45367,2456,920,1722,1471,734,634
48216,1848,870,1059,1135,789,740
50853,1164,691,462,199,702,492
53601,1104,557,419,62,685,495
55985,1495,695,781,146,714,549
57755,1950,911,1182,362,768,549
58573,2628,949,1693,903,935,804
58085,2960,949,2049,1125,911,681
56446,3631,1018,2496,1912,1135,894
54066,3652,1087,2659,2034,993,947
52459,3690,1523,3025,2509,665,986
50838,3229,1325,2672,1660,557,335
46763,3895,1464,3193,1881,702,417
42386,4890,2069,4063,2732,827,663
38692,5461,3602,4228,4380,1233,778
35977,4395,2700,3583,3834,812,1134
34222,3245,1841,2916,2150,329,309
33192,3294,2298,3011,2499,283,201
32903,3140,3965,3012,4595,128,630
34068,1669,834,1626,856,43,22
35857,2016,1338,1823,1400,193,62
37269,1880,1363,1699,1506,181,143
39367,1381,1307,1372,1468,9,161
42397,757,464,736,451,21,13
46149,587,292,542,287,45,5
49736,526,279,344,262,182,17
52893,646,497,387,311,259,187
55745,605,350,374,158,231,192
57837,786,544,579,251,207,293
59129,704,271,326,147,378,124
59535,744,242,256,53,488,189
58703,806,316,179,52,627,264
56733,962,588,401,65,561,653
54281,913,629,597,367,316,463
52633,810,313,560,198,250,115
50907,1068,566,847,347,221,219
46816,1230,638,1070,511,160,127
42343,1332,540,1193,484,139,56
38662,1838,911,1622,1014,216,103
36226,2027,834,1864,730,163,104
34372,3015,1683,2596,1820,419,137
33228,3235,1887,2916,2306,319,419
32959,2689,1471,2292,1620,397,149
34142,2811,3094,2514,3929,297,835
35819,1415,589,1365,531,50,58
37300,1646,677,1588,665,58,12
39791,2216,1233,2128,1264,88,31
43080,2510,1815,2442,1890,68,75
46948,2237,1267,2213,1329,24,62
50567,2126,1361,1998,1362,128,1
53603,2157,1323,2006,1461,151,138
56261,1759,903,1576,966,183,63
57914,1849,891,1496,969,353,119
57828,1902,880,1313,975,589,334
56474,1850,888,1104,877,746,534
54655,1604,745,948,543,656,485
52649,1743,824,1006,593,737,485
50016,2004,876,1310,888,694,625
48242,2099,926,1564,924,535,357
46554,2655,998,2184,1355,471,357
43084,3122,1568,2678,1876,444,308
39187,3437,2278,2995,2635,442,357
35973,3121,1771,2739,2009,382,238
33673,3463,2401,2978,2803,485,402
32063,3238,2314,2716,2718,522,404
31141,2685,1456,2199,1730,486,274
30961,2604,1352,2267,1652,337,300
32114,2472,1857,2284,2058,188,201
33925,2015,1341,1847,1377,168,36
35216,1896,921,1582,959,314,38
36831,2237,990,1986,1217,251,227
38778,2170,900,2010,999,160,99
41151,2537,1331,2462,1409,75,78
43250,2836,1693,2727,1730,109,37
44887,3075,1954,2906,2025,169,71
46455,3155,2157,3010,2323,145,166
47646,2900,2109,2685,2268,215,159
48462,2485,1537,2070,1703,415,166
48489,2371,1064,1755,1495,616,431
47143,2116,912,1471,1010,645,462
45426,2193,912,1686,966,507,476
43745,2268,898,1860,1064,408,294
43148,2560,1342,2206,1600,354,258
42568,2529,1546,2271,1769,258,223
39833,2531,1601,2240,1862,291,261
36318,2317,1315,2026,1483,291,168
33452,2411,1599,2142,1778,269,179
31495,2223,1394,2037,1494,186,100
30337,2130,1443,1978,1513,152,70
29612,1535,849,1451,887,84,38
29674,1418,860,1317,891,101,31
30827,1120,580,1036,564,84,16
32485,1103,638,1040,630,63,8
33906,1041,673,1007,674,34,1
35716,867,532,849,533,18,1
37920,754,392,747,391,7,1
40533,696,434,684,421,12,13
42780,632,314,568,301,64,13
45032,667,352,450,284,217,68
47214,701,322,410,151,291,171
49210,816,448,459,190,357,258
50296,913,421,458,154,455,267
50247,1106,611,619,236,487,466
49205,1131,679,725,365,406,400
47681,1120,653,732,443,388,210
45518,1226,649,767,464,459,185
43903,1392,789,977,563,415,226
42776,1607,781,1259,637,348,144
40129,2369,1011,2013,1195,356,184
36992,3029,1421,2694,1666,335,245
33947,3861,2689,3444,3000,417,311
31812,4133,3082,3768,3396,365,314
30241,3861,2721,3491,2968,370,247
29193,3732,2551,3334,2829,398,278
28839,3606,2174,3137,2446,469,272
29079,3898,2307,3397,2677,501,370
29382,4124,2610,3583,3002,541,392
30539,4371,2910,3824,3322,547,412
33465,4360,2841,3908,3235,452,394
37124,4033,2039,3638,2300,395,261
40813,4734,2951,4184,3301,550,350
44076,4614,3149,4038,3661,576,512
46962,3723,2439,3200,2867,523,428
49357,2902,1726,2370,2107,532,381
51268,2319,1080,1828,1508,491,428
52626,1951,904,1456,999,495,320
53311,2156,942,1588,1040,568,357
53069,2726,957,2085,1430,641,473
51748,3463,1425,2800,1945,663,520
49794,4109,1726,3392,2238,717,512
47901,5487,3119,4457,3862,1030,743
46483,6232,3731,4914,4699,1318,968
43659,7125,4873,5571,6154,1554,1281
40299,7338,5548,5761,6984,1577,1436
37209,7204,5579,5749,6837,1455,1258
35064,7269,5594,5888,6766,1381,1172
33251,7221,5458,5856,6579,1365,1121
31920,7211,5394,5771,6543,1440,1149
31230,7328,5621,5788,6866,1540,1245
31084,7303,5581,5783,6865,1520,1284
30714,6957,5149,5647,6360,1310,1211
31531,6560,4331,5362,5325,1198,994
34406,6090,3770,4933,4714,1157,944
37608,5207,2743,4137,3543,1070,800
41147,4625,2506,3708,3344,917,838
44585,3629,2311,2846,2990,783,679
47750,2393,964,1685,1388,708,424
50598,2118,892,1126,1067,992,610
52804,1888,705,748,604,1140,850
54555,1894,649,714,456,1180,1055
55582,2081,729,853,594,1228,1156
55879,2225,839,1000,678,1225,1138
55037,2361,874,1190,791,1171,1143
53182,2756,942,1354,1391,1402,1298
51527,3384,945,2007,1756,1377,1125
50460,4280,998,2791,2244,1489,1246
47111,5272,1632,3622,3049,1650,1417
43222,6159,2558,4205,4324,1954,1766
39604,5982,2113,4344,3753,1638,1640
37515,6093,2564,4633,3935,1460,1371
36182,6390,3224,5033,4594,1357,1370
35368,6185,3377,4950,4542,1235,1165
35497,6106,3571,4942,4696,1164,1125
36668,5770,3570,4745,4627,1025,1057
38162,5074,3114,4176,3970,898,856
39629,4486,2469,3702,3173,784,704
42106,4074,2394,3166,3140,908,746
45303,3199,1218,2303,1904,896,686
49271,2774,882,1791,1537,983,790
52742,2194,855,1117,1022,1077,841
55598,1678,741,553,447,1125,878
58332,1459,650,396,240,1063,890
60470,1515,752,344,283,1171,1035
61668,1572,820,355,265,1217,1085
62069,1734,756,526,319,1208,1075
61691,2122,726,842,649,1280,1020
60160,2901,886,1812,859,1089,740
57553,4103,1024,2875,2432,1228,1408
55823,4069,1112,3004,2123,1065,1011
54169,4755,2110,3541,3177,1214,1067
50296,4578,1609,3394,2584,1184,975
45693,4706,1708,3544,2688,1162,980
41591,4741,2229,3413,3403,1328,1174
38771,3818,1361,2678,2326,1140,965
36830,3554,1365,2434,2358,1120,993
35613,3225,1674,1982,2829,1243,1155
35257,2292,850,1741,1037,551,650
36156,2293,804,1924,1110,369,329
37921,2696,1372,2395,1649,301,277
39029,2725,2084,2290,2355,435,271
41188,2202,1298,1728,1592,474,294
43806,2053,896,1614,1251,439,355
46990,2011,836,1565,1155,446,319
49928,1923,701,1493,678,430,260
52626,2751,785,2024,1035,727,392
55047,3754,987,2711,1716,1043,729
55797,4139,1037,2941,1872,1198,835
55492,4748,1322,3464,2437,1284,1115
54162,4950,1800,3807,2960,1143,1160
51740,4599,2153,3464,3052,1135,899
49901,4195,1600,3019,2402,1176,802
48209,4332,1452,3155,2436,1177,984
46712,4541,2131,3409,3321,1132,1190
45099,3861,1423,2908,2060,953,637
41580,4586,1657,3512,2403,1074,746
37678,5537,2574,4218,3678,1319,1104
34433,5971,3204,4584,4319,1387,1115
32368,5809,3152,4467,4324,1342,1172
31126,5799,3499,4551,4715,1248,1216
30621,5638,3843,4680,4993,958,1150
30722,4237,2376,3345,2883,892,507
32062,4825,3732,3817,4552,1008,820
33891,3370,2524,2812,3273,558,749
35144,2136,1287,1756,1483,380,196
36778,2475,1686,2085,1980,390,294
38952,2207,888,1821,1039,386,151
41661,2872,1295,2449,1653,423,358
44250,2973,1069,2450,1308,523,239
46726,3891,1445,3068,1925,823,480
49335,4793,2206,3601,3195,1192,989
51933,4151,1550,2908,2644,1243,1094
54207,3465,860,2269,1795,1196,992
55426,3167,843,2001,1325,1166,950
55265,3397,879,2101,1549,1296,1149
53766,3449,898,1849,1819,1600,1246
51542,3428,901,1807,1596,1621,1409
49834,3484,901,2042,1569,1442,1379
48660,3726,901,2468,1743,1258,1144
45325,4089,905,2995,1929,1094,1024
41265,4804,1912,3466,3062,1338,1150
37995,4826,1764,3532,2881,1294,1117
35709,4925,1717,3710,2785,1215,1068
34202,5474,2445,4180,3565,1294,1120
33384,5469,2327,4254,3330,1215,1003
33348,5923,2956,4749,4111,1174,1155
34548,5734,3254,4623,4278,1111,1024
36363,5487,3097,4443,4060,1044,963
37756,5278,2692,4244,3576,1034,884
40064,5510,2826,4242,3778,1268,952
42997,5413,2194,4110,3249,1303,1055
46223,5521,2344,4087,3576,1434,1232
49510,5028,1992,3544,3320,1484,1328
52145,4311,1271,2856,2574,1455,1303
54511,3879,900,2402,2075,1477,1298
56595,3730,901,2250,1796,1480,1324
58135,3695,900,2265,1666,1430,1287
58761,3983,903,2591,1825,1392,1285
57988,4377,903,2980,2102,1397,1242
56313,5050,1371,3497,2689,1553,1318
54140,5547,1601,3938,2972,1609,1371
52353,6097,1993,4485,3416,1612,1423
51180,6607,2541,5010,3981,1597,1440
47605,6924,2975,5274,4443,1650,1468
43361,6748,3086,5106,4663,1642,1577
39811,6094,2967,4566,4429,1528,1462
37354,5330,2091,3888,3235,1442,1144
35520,5462,2483,4005,3968,1457,1485
34378,4684,2485,3281,3914,1403,1429
34153,3758,1909,2596,3182,1162,1273
35003,2977,916,2264,1501,713,585
36282,3526,1280,2856,1803,670,523
37429,4354,2234,3589,2928,765,694
39423,4266,2193,3391,2801,875,608
42202,4452,2080,3304,2891,1148,811
45258,4566,2067,3227,3299,1339,1232
47987,3783,1257,2624,2347,1159,1090
50431,3458,886,2286,1554,1172,798
53046,4103,887,2679,2053,1424,1244
55197,4065,885,2641,2042,1424,1281
56874,3870,886,2524,1898,1346,1185
57743,3960,936,2583,2191,1377,1255
57247,3806,902,2525,1974,1281,1118
55475,3727,904,2578,1605,1149,919
52901,4319,1085,3111,2076,1208,991
50638,5045,2135,3697,3517,1348,1382
49061,4542,1921,3411,3038,1131,1117
46011,4282,1752,3133,2665,1149,913
42469,4309,1644,3089,2820,1220,1176
39163,3863,1208,2829,2173,1034,965
36605,4008,1613,3220,2624,788,1011
34640,3848,2707,3036,3459,812,752
33258,3218,2665,2452,3512,766,847
32440,2448,1488,1896,1966,552,478
32423,2443,1712,1936,2110,507,398
32620,2748,2130,2194,2420,554,290
33414,2489,1197,2116,1433,373,236
36225,2806,1809,2457,2066,349,257
39686,2369,1111,2031,1217,338,106
43149,2649,1635,2171,1901,478,266
45879,2018,915,1629,1064,389,295
47876,1750,908,1325,714,425,258
49416,1760,910,1212,629,548,367
50641,1861,903,1125,628,736,518
51965,1926,897,1084,491,842,563
52880,2314,914,1366,633,948,697
52918,2622,919,1623,758,999,699
51575,3297,918,2047,1680,1250,1104
49421,2958,915,2035,1201,923,762
47702,3329,922,2488,1102,841,492
46722,5036,1862,3985,2742,1051,880
43897,5571,3318,4422,4386,1149,1068
40550,4718,3522,3822,4566,896,1044
37020,3431,2786,2892,3374,539,588
34523,2585,2092,2312,2325,273,233
32620,2144,1208,1882,1292,262,84
31361,2510,1510,2155,1752,355,242
30508,2440,1999,2123,2404,317,405
30228,1800,1700,1631,1996,169,296
29895,1311,1171,1229,1245,82,74
30701,1090,749,1071,712,19,37
33936,1074,737,1037,726,37,11
37627,1022,386,936,384,86,2
41120,1140,339,1012,327,128,12
44323,1589,927,1436,1053,153,126
47101,1153,620,979,589,174,31
49188,900,384,634,303,266,81
50728,981,393,712,211,269,182
51418,1224,376,918,246,306,130
51083,1994,917,1370,660,624,274
50402,2821,917,2027,1289,794,630
48894,3459,997,2632,1635,827,638
47126,4102,1420,3156,2034,946,614
45978,5282,2279,4332,3190,950,911
45278,5767,3443,4877,4300,890,857
42626,5479,2955,4629,3501,850,546
38968,6294,3807,5389,4585,905,778
35685,6564,5033,5549,5863,1015,830
33750,6392,4850,5471,5598,921,748
32258,6259,4949,5384,5695,875,746
31531,5969,4661,5100,5307,869,646
31566,5938,4507,5008,5160,930,653
32762,6094,4462,5208,5170,886,708
34390,6143,4401,5377,5034,766,633
36290,5795,4030,5133,4594,662,564
38778,5484,3628,4908,4133,576,505
41917,5325,3719,4737,4182,588,463
45233,4814,3263,4253,3698,561,435
48283,4379,2814,3821,3234,558,420
50921,4268,2719,3642,3234,626,515
53209,4124,1983,3405,2542,719,559
54752,4718,1990,3696,2665,1022,675
55825,5754,2364,4316,3519,1438,1155
56346,6198,2439,4579,3858,1619,1419
55851,6362,2451,4672,3879,1690,1428
54459,6663,2604,5116,4078,1547,1474
52434,6971,3189,5494,4486,1477,1297
50637,7504,4000,5864,5346,1640,1346
49769,7916,4444,6182,5986,1734,1542
46357,7846,4485,6157,6017,1689,1532
42140,7825,4739,6115,6270,1710,1531
38638,7683,4800,6017,6300,1666,1500
36410,7602,4852,6018,6240,1584,1388
34851,7395,4727,5979,6047,1416,1320
33943,7072,4549,5786,5670,1286,1121
33867,7019,4712,5756,5778,1263,1066
35106,7073,4862,5726,5908,1347,1046
36797,6888,4367,5576,5458,1312,1091
38095,6915,4292,5583,5417,1332,1125
40241,7190,4382,5635,5504,1555,1122
42728,7589,4297,5837,5761,1752,1464
45633,7765,4139,5958,5771,1807,1632
47852,7675,3727,5814,5389,1861,1662
49412,7796,3781,5910,5516,1886,1735
51369,7410,3250,5646,4922,1764,1672
52656,7284,3114,5562,4714,1722,1600
53016,7365,3072,5617,4645,1748,1573
52242,7657,3275,5836,4935,1821,1660
50856,7766,3341,5935,4987,1831,1646
49423,8029,3644,6142,5348,1887,1704
47846,8110,3781,6224,5474,1886,1693
46676,8182,4057,6321,5793,1861,1736
46213,7953,4225,6215,5902,1738,1677
43385,7558,3918,6097,5361,1461,1443
39773,7628,4473,6239,5802,1389,1329
36706,7612,4999,6253,6340,1359,1341
34759,7372,5118,5945,6359,1427,1241
33484,7393,5076,6007,6350,1386,1274
32858,7170,4922,5855,6083,1315,1161
32913,7085,4911,5790,5992,1295,1081
34284,7070,4885,5895,5931,1175,1046
36203,6820,4416,5511,5276,1309,860
37706,7076,4307,5831,5433,1245,1126
39780,7124,4605,6066,5645,1058,1040
42317,7332,5067,6274,6005,1058,938
45316,7308,4815,6376,5796,932,981
47895,7180,4790,6168,5719,1012,929
49716,7147,4825,5926,5918,1221,1093
50843,7203,4477,5889,5652,1314,1175
51711,6934,3807,5672,5063,1262,1256
52649,6515,3541,5340,4700,1175,1159
52993,6036,3039,4819,4074,1217,1035
52359,5976,2806,4594,3855,1382,1049
50587,6286,2868,4971,4241,1315,1373
48783,6198,3195,5094,4298,1104,1103
47397,6442,3827,5324,4813,1118,986
46685,6593,4140,5519,5192,1074,1052
43539,6430,3992,5436,4914,994,922
39573,6479,4243,5441,5097,1038,854
36489,6494,4448,5396,5346,1098,898
34311,6178,4451,5305,5420,873,969
32820,5094,3426,4429,3932,665,506
32055,4774,3169,4099,3629,675,460
31908,4392,2915,3863,3442,529,527
33175,3641,2169,3229,2461,412,292
34875,3383,2179,2941,2452,442,273
36422,2815,1615,2361,1864,454,249
38774,2289,1061,1948,1274,341,213
41895,2112,1250,1890,1462,222,212
45220,1536,1195,1402,1283,134,88
48301,916,722,860,766,56,44
50911,602,282,510,243,92,39
53307,734,325,575,230,159,95
55113,954,350,694,235,260,115
56296,1278,531,872,341,406,190
56618,1737,913,1093,660,644,359
55756,1873,942,1274,671,599,473
54108,1944,943,1494,877,450,388
52051,1827,976,1516,1294,311,318
50078,1511,1303,1148,1386,363,83
48637,1166,584,951,503,215,81
44939,1381,697,1208,618,173,79
40770,1664,897,1472,945,192,80
37157,1762,917,1515,1004,247,87
34603,1834,875,1572,998,262,158
32921,1808,878,1534,949,274,158
31871,1815,862,1490,999,325,167
31725,1734,904,1396,847,338,156
32681,1678,915,1360,778,318,146
34043,1677,915,1359,865,318,122
35769,1526,910,1268,913,258,128
38843,1138,850,917,883,221,86
42398,599,142,446,131,153,11
46270,587,228,395,115,192,113
49564,609,284,375,126,234,158
52379,598,228,372,100,226,128
55095,767,345,492,155,275,190
56961,864,324,618,147,246,177
58254,994,314,756,189,238,125
58929,1241,519,925,390,316,129
58452,1340,604,993,431,347,173
56793,1509,810,1146,599,363,211
54456,1592,800,1268,615,324,185
52022,1871,956,1561,885,310,181
50224,2194,1031,1865,1265,329,234
46713,2428,1162,2140,1376,288,214
42774,2854,1694,2577,1908,277,214
39224,3073,2101,2800,2307,273,206
36497,2972,1867,2727,2030,245,163
34478,3121,1907,2895,2065,226,158
33074,3310,2149,3086,2299,224,150
32258,3382,2293,3175,2440,207,147
32254,3328,2481,3124,2626,204,145
32300,2996,2374,2818,2505,178,131
33390,2355,1775,2222,1851,133,76
36766,1875,1625,1811,1640,64,15
41018,1242,523,1198,522,44,1
45385,1339,780,1248,777,91,3
49111,1123,489,951,473,172,16
51850,1046,377,799,280,247,97
53951,1234,532,897,321,337,211
55510,1365,607,1009,343,356,264
56678,1610,774,1118,496,492,278
57327,1875,958,1265,647,610,408
57202,2051,958,1307,873,744,525
56029,2082,959,1296,928,786,566
53872,2107,958,1356,929,751,533
51517,2309,958,1621,1135,688,544
50008,2610,957,1985,1397,625,450
46706,2994,1233,2462,1637,532,404
42980,3471,1883,2940,2237,531,354
39640,3619,2000,3155,2311,464,311
36951,3801,2261,3406,2533,395,272
34881,3857,2608,3511,2878,346,270
33363,3622,2613,3367,2851,255,238
32326,3296,2455,3121,2626,175,171
31945,3056,2246,2864,2349,192,103
31433,2943,1953,2708,2086,235,133
32061,2837,1827,2602,2006,235,179
35478,2615,1822,2366,1991,249,169
39860,2107,945,1878,1050,229,105
44433,2268,1507,2017,1732,251,225
48614,1487,974,1291,1079,196,105
52073,772,271,647,236,125,35
54861,510,178,355,141,155,37
56991,563,244,342,124,221,120
58493,563,223,313,85,250,138
59421,615,257,341,86,274,171
59613,608,211,307,81,301,130
58803,675,311,365,94,310,217
56796,691,187,454,78,237,109
54482,987,320,756,192,231,128
52790,1325,497,1076,394,249,103
48768,2008,911,1683,985,325,186
44009,2478,1247,2136,1486,342,239
40159,2684,1462,2295,1676,389,214
37470,2869,1654,2523,1936,346,282
35670,2766,1727,2474,1943,292,216
34481,2563,1515,2295,1663,268,148
34135,2517,1443,2242,1603,275,160
35033,2405,1440,2072,1618,333,178
36396,1921,1064,1614,1220,307,156
38354,1363,770,1134,677,229,93
41764,952,604,785,550,167,54
46114,465,119,304,118,161,1
50809,270,13,210,8,60,5
55131,185,2,147,1,38,1
58715,149,2,128,1,21,1
61538,255,12,188,1,67,11
63682,427,24,282,1,145,23
64566,530,32,288,6,242,26
65090,670,113,374,17,296,96
64766,704,121,419,13,285,108
64007,851,213,559,104,292,109
61845,1011,363,730,274,281,89
59283,1289,610,1024,504,265,106
57011,1686,868,1391,758,295,110
52536,2326,1066,1985,1234,341,168
47450,2842,1693,2494,1932,348,239
43103,2852,1859,2426,2035,426,176
40038,2741,1603,2290,1859,451,256
37979,2615,1286,2143,1544,472,258
36562,2664,1344,2188,1685,476,341
35989,2411,1154,1996,1441,415,287
36762,2175,1001,1790,1235,385,234
38140,1931,953,1605,1050,326,198
39715,1593,864,1369,765,224,99
42906,1375,987,1241,1037,134,50
47254,726,237,640,236,86,1
52356,431,18,370,17,61,1
57090,309,21,289,20,20,1
60977,137,2,127,1,10,1
64129,184,4,130,3,54,1
66046,244,9,102,5,142,4
66569,338,78,116,6,222,72
66635,457,156,166,7,291,149
66317,552,176,211,19,341,157
65507,700,265,331,54,369,211
63242,1001,397,542,168,459,229
61259,1415,697,942,436,473,261
59258,2137,944,1682,957,455,314
54983,2935,1219,2420,1544,515,325
50186,3802,2080,3278,2582,524,502
46027,3939,2327,3383,2763,556,436
43105,4130,2446,3580,2888,550,442
40862,4392,3040,3906,3542,486,502
39337,3958,2694,3575,3037,383,343
38705,3707,2571,3161,2849,546,278
39354,3473,2141,2963,2579,510,438
40614,2955,1788,2582,2108,373,320
41842,2454,1584,2185,1782,269,198
44441,1853,1314,1704,1383,149,69
48042,1334,798,1201,762,133,36
52278,1020,598,932,558,88,40
56353,594,214,519,208,75,6
59960,388,48,190,38,198,10
62913,510,136,189,15,321,121
64777,800,333,362,15,438,318
65629,1087,487,519,133,568,354
66076,1698,961,844,683,854,672
65626,1986,957,1101,983,885,645
63837,2522,958,1600,1720,922,827
61198,2591,958,1748,1551,843,608
58582,2964,1104,2144,1775,820,671
56657,3369,1358,2659,1969,710,611
52586,3855,1671,3214,2210,641,539
47784,4522,2504,3778,3068,744,564
43771,4649,2627,3910,3238,739,611
40740,4601,2761,3906,3344,695,583
38667,4464,2515,3850,2976,614,461
37434,4731,2880,4100,3344,631,464
37058,4900,3178,4209,3647,691,469
37862,5083,3480,4378,4000,705,520
39329,4907,3226,4263,3697,644,471
40663,4554,2996,4019,3435,535,439
43470,4205,2935,3767,3318,438,383
47153,3604,1824,3132,2033,472,209
51177,4186,2951,3595,3445,591,494
54775,3131,2095,2583,2511,548,416
57631,2283,1073,1679,1471,604,398
59581,1776,946,1080,867,696,486
60830,1458,902,795,389,663,560
61686,1380,646,770,221,610,425
61593,1893,951,1044,708,849,698
60893,2033,955,1122,817,911,711
59537,2302,958,1261,1117,1041,804
57485,2481,958,1536,1093,945,727
55392,2905,959,2029,1404,876,707
54025,3509,1229,2654,1925,855,696
50328,4104,1625,3243,2264,861,639
46064,4952,2284,4105,3020,847,736
42437,5444,3080,4579,3752,865,672
39990,5808,3585,4982,4254,826,669
38240,5565,3452,4795,4033,770,581
37105,5433,3460,4724,3995,709,535
36716,5305,3400,4620,3883,685,483
37327,5172,3722,4531,4244,641,522
38385,4294,2748,3782,3126,512,378
39549,3934,2650,3518,2996,416,346
42450,3297,2210,2951,2451,346,241
45936,2745,1324,2404,1465,341,141
49472,2941,1688,2517,1959,424,271
52425,2312,1312,1977,1588,335,276
54622,1761,935,1410,1203,351,375
56720,1139,572,694,305,445,267
58075,1054,437,461,87,593,350
58755,1383,661,488,84,895,577
58842,1870,932,762,297,1108,1173
58003,1870,943,993,498,877,970
56255,2032,951,1161,837,871,663
54105,2416,955,1426,1036,990,685
52117,3096,957,2060,1711,1036,1035
50777,3391,1199,2424,1974,967,775
47849,3913,1488,3049,2197,864,709
44540,4767,2193,3900,2889,867,696
41306,5568,3056,4784,3814,784,758
38827,5799,3856,5022,4471,777,615
36896,5479,3718,4833,4281,646,563
35434,4856,3421,4271,3838,585,417
34677,4171,2776,3680,3129,491,353
34703,3635,2134,3251,2409,384,275
34795,3499,2043,3206,2277,293,234
35593,3299,2249,3033,2413,266,164
38339,2832,1856,2412,1999,420,143
41616,2256,954,1764,1245,492,291
44835,1794,936,1286,1146,508,588
47351,856,213,464,88,392,125
49213,1000,376,542,74,458,302
50072,1311,623,757,173,554,450
50461,1576,918,943,305,633,666
50655,1683,934,1017,416,666,670
50934,1956,955,1294,775,662,779
51116,1987,957,1342,887,645,612
50388,2200,959,1539,1048,661,614
48648,2496,958,1963,1312,533,645
47265,2900,1422,2390,1956,510,534
46297,3244,1961,2778,2553,466,592
43724,3386,1673,2906,2066,480,393
40848,4189,2113,3777,2595,412,482
37902,4874,3147,4294,3584,580,437
35663,4801,2971,4182,3458,619,487
33911,4519,2763,3965,3343,554,580
32672,3908,2509,3502,2960,406,451
31859,3119,1935,2727,2151,392,216
31697,2684,1457,2383,1698,301,241
31607,2244,1368,2021,1571,223,203
32158,1586,935,1393,1061,193,126
34545,1037,422,863,332,174,90
37050,1041,584,819,454,222,130
39664,954,671,797,362,157,309
42204,741,343,533,168,208,175
44148,914,290,532,76,382,214
45834,1612,838,933,259,679,579
47027,2169,945,1184,557,985,663
47662,2948,959,1757,1102,1191,1130
47510,3199,959,1870,1513,1329,1206
47100,3262,958,1809,1693,1453,1337
46243,3194,958,1947,1197,1247,979
45172,3982,959,2697,1548,1285,960
44467,5310,1628,3916,2983,1394,1355
44307,5727,2636,4382,3961,1345,1325
42059,5499,2497,4483,3529,1016,1032
38980,5802,3176,4726,4048,1076,872
36207,5848,3061,4673,3958,1175,897
34285,5820,3108,4562,4190,1258,1082
33204,5170,2759,4004,3797,1166,1038
32694,4361,2080,3385,2954,976,874
33036,4024,1753,3077,2428,947,675
34489,4179,1819,3209,2563,970,744
36346,4147,1893,3153,2685,994,792
37625,3862,1552,2967,2329,895,777
39911,3768,1260,2995,1867,773,607
43144,4582,1584,3542,2240,1040,656
46541,5658,2129,4268,3231,1390,1102
49359,5810,2201,4294,3512,1516,1311
51869,5546,1997,4095,3299,1451,1302
54234,5369,1927,3985,3153,1384,1226
55621,5563,2150,4183,3400,1380,1250
56399,5625,2233,4177,3482,1448,1249
56437,5819,1952,4366,3275,1453,1323
55508,6309,2540,4824,3969,1485,1429
53842,6138,2668,4749,3942,1389,1274
51804,5995,2668,4646,3827,1349,1159
50425,6074,2872,4700,4075,1374,1203
49463,5969,3260,4657,4665,1312,1405
46262,5144,2483,4033,3442,1111,959
42478,5315,2440,4156,3375,1159,935
39224,5810,2997,4568,4101,1242,1104
36911,5727,3055,4578,4072,1149,1017
35328,5690,3272,4683,4198,1007,926
34421,5576,3589,4736,4374,840,785
34284,5216,3712,4521,4337,695,625
35279,4646,3256,4020,3684,626,428
36733,4297,2704,3724,3079,573,375
37841,4390,2716,3797,3119,593,403
40550,4400,2297,3891,2680,509,383
43889,5046,2600,4346,2980,700,380
47106,6148,3479,5096,4193,1052,714
50236,6265,3432,4995,4448,1270,1016
52607,5833,2768,4536,3871,1297,1103
55202,5508,2340,4107,3485,1401,1145
56624,5352,2036,3796,3342,1556,1306
57573,5201,1600,3677,2939,1524,1339
57702,5501,1876,3876,3304,1625,1428
56736,5715,1965,4054,3414,1661,1449
55067,5860,1940,4273,3335,1587,1395
52787,6130,2156,4630,3499,1500,1343
50737,6566,2893,5059,4288,1507,1395
49320,6441,3299,4916,4734,1525,1435
46116,5723,2777,4344,4069,1379,1292
42636,5279,2541,4037,3711,1242,1170
39522,5035,2545,3880,3574,1155,1029
37152,4860,2384,3760,3270,1100,886
35442,4919,2455,3881,3350,1038,895
34293,4924,2504,3995,3322,929,818
33745,5091,2919,4203,3657,888,738
33766,5129,3185,4309,3875,820,690
33599,4977,3289,4162,3900,815,611
33938,4752,2887,3989,3462,763,575
37001,4851,2406,4079,2904,772,498
40922,5819,3200,4687,3941,1132,741
45145,5938,3287,4596,4426,1342,1139
48694,5037,2235,3797,3317,1240,1082
51542,4560,1634,3280,2651,1280,1017
53440,4502,1327,3102,2476,1400,1149
54753,4646,1216,3133,2554,1513,1338
55440,4708,1074,3291,2366,1417,1292
55649,5102,1435,3635,2722,1467,1287
55493,5342,1562,3858,2827,1484,1265
54161,5691,1912,4097,3344,1594,1432
51929,5568,1840,4080,3170,1488,1330
49389,5804,2638,4308,4175,1496,1537
47599,5032,2581,3650,4042,1382,1461
45151,3969,1413,2941,2453,1028,1040
42450,3941,1474,2930,2359,1011,885
39342,4149,1709,3025,2649,1124,940
36958,4170,1527,3097,2426,1073,899
35309,4576,2017,3471,2940,1105,923
34330,4667,2322,3654,3260,1013,938
34078,4526,2626,3682,3390,844,764
34874,4324,2792,3577,3387,747,595
36066,4069,2695,3368,3202,701,507
37372,3767,2320,2990,2797,777,477
40636,3793,2031,3030,2573,763,542
44644,3663,1510,2935,1986,728,476
47840,3989,2140,3213,2801,776,661
51373,3323,1509,2679,2007,644,498
54219,3118,1177,2443,1630,675,453
56722,3397,1101,2529,1732,868,631
58596,3753,1032,2675,1884,1078,852
59998,4023,1010,2767,2073,1256,1063
60761,4186,1144,2765,2413,1421,1269
60319,3954,920,2644,2000,1310,1114
58675,3942,926,2826,1594,1116,883
56050,4889,1759,3591,2916,1298,1157
53662,4756,2564,3421,3930,1335,1366
51938,3535,1479,2533,2497,1002,1018
48124,3024,1167,2335,1952,689,785
43818,2842,1467,2166,2028,676,561
40167,2657,1338,1960,1892,697,554
37518,2550,1244,1884,1850,666,606
35655,2313,1300,1691,1846,622,546
34489,1883,946,1538,830,345,219
34105,2487,1275,2083,1465,404,190
34898,2721,1363,2342,1617,379,254
35985,2777,1515,2466,1752,311,237
37226,2619,1480,2322,1657,297,177
40294,2460,1351,2220,1537,240,186
44022,2192,970,1926,1069,266,99
47948,2493,1637,2144,1862,349,225
51462,1736,916,1501,949,235,122
54522,1396,607,1168,540,228,67
57191,1485,666,1118,520,367,146
59068,1747,859,1211,635,536,318
60365,1912,899,1192,681,720,470
60751,1993,935,1201,653,792,618
60360,1984,952,1177,658,807,656
58618,1907,952,1073,634,834,613
56153,1911,954,1084,594,827,619
53781,2092,954,1239,879,853,704
52064,2108,954,1344,820,764,546
48610,2513,954,1710,1132,803,578
44923,2901,956,2142,1475,759,617
41447,3092,1131,2459,1610,633,479
38692,3384,1645,2815,2068,569,423
36644,3288,1837,2827,2154,461,317
35171,2999,1703,2651,1911,348,208
34301,2911,1866,2584,2040,327,174
34124,2574,1548,2301,1671,273,123
34062,2346,1334,2111,1456,235,122
34457,1995,1047,1795,1145,200,98
37417,1668,1063,1499,1159,169,96
41512,969,302,813,282,156,20
45748,876,385,705,320,171,65
49689,351,63,248,48,103,15
53052,248,50,93,20,155,30
55479,383,127,135,4,248,123
57158,673,353,202,40,471,313
57470,834,466,296,43,538,472
55613,963,521,358,96,605,499
53352,1072,558,441,139,631,437
50650,1371,681,563,229,808,563
48469,1698,792,856,390,842,719
46909,2219,935,1488,1033,731,750
46015,2449,927,1660,1379,789,606
43383,2631,950,1841,1017,790,491
40350,3308,1054,2457,1799,851,745
37538,3249,1280,2403,1857,846,577
35255,3195,1166,2483,1734,712,568
33762,3119,1444,2484,1918,635,474
32696,2676,1185,2133,1498,543,313
32129,2393,1015,1940,1299,453,284
32044,2037,943,1667,1105,370,192
32118,1624,896,1327,786,297,138
32109,1228,501,1009,435,219,66
34362,1071,487,883,421,188,66
37356,783,230,541,196,242,34
40577,687,199,447,111,240,88
43513,466,74,225,17,241,57
46477,284,68,47,1,237,67
48543,352,109,64,1,288,108
50211,708,287,258,8,450,279
51382,1167,518,475,66,692,452
52155,1525,715,697,228,828,663
51929,1817,822,925,410,892,673
50638,2128,881,1284,561,844,699
48323,2504,908,1553,928,951,765
47079,2785,949,1860,1208,925,780
46411,2788,952,1671,1962,1117,1159
43662,1844,877,902,559,942,553
40222,2090,896,1121,605,969,858
37229,2399,930,1419,953,980,936
35335,2244,922,1379,860,865,635
34173,2615,937,1292,2106,1323,1174
33580,1840,904,574,1330,1266,1200
33768,1220,725,536,227,684,498
35005,1182,778,578,367,604,536
37040,1122,800,467,445,655,355
38265,845,467,422,142,423,325
39948,721,414,416,182,305,232
42547,689,332,298,197,391,135
45515,591,287,309,113,282,174
48427,502,155,323,71,179,84
50426,576,116,384,44,192,72
51514,749,138,462,49,287,89
52509,1318,412,842,171,476,241
53607,2496,909,1707,655,789,574
54291,3571,902,2305,1544,1266,991
53861,3670,914,2112,1746,1558,1339
52085,3152,912,1777,1231,1375,1338
49817,2721,888,1334,1100,1387,1277
48442,2193,885,914,550,1279,1163
46931,1893,835,755,288,1138,1085
43641,1787,740,638,368,1149,1108
39882,1622,778,575,332,1047,1110
36826,1389,669,507,206,882,774
34873,1462,657,353,311,1109,959
33525,1379,1020,349,141,1030,1161
32702,1276,872,442,180,834,1052
32585,1088,658,566,129,522,529
33677,1204,740,771,263,433,486
35459,1288,656,901,321,387,335
36540,1395,770,1045,451,350,319
38065,1313,821,950,548,363,273
39955,1019,358,558,209,461,149
42503,1137,624,484,205,653,419
44569,1052,664,588,69,464,600
46577,1002,478,647,109,355,369
48340,1018,317,706,137,312,180
49823,1565,821,1018,403,547,418
51061,2133,846,1227,767,906,807
51603,2309,821,1297,774,1012,900
51234,2513,847,1632,770,881,936
50005,2934,823,1315,2026,1619,1238
47871,2090,845,961,408,1129,1027
46603,2235,851,994,807,1241,1415
45265,1704,812,863,392,841,891
42406,1571,841,977,378,594,652
38824,1530,874,998,411,532,463
35887,1684,875,995,715,689,647
33915,1305,791,737,285,568,506
32580,1164,597,635,165,529,432
31893,1101,488,562,172,539,316
31992,1095,541,605,173,490,368
33178,1014,374,555,161,459,213
35067,1070,351,657,140,413,211
36291,1237,549,830,275,407,274
38028,1165,575,675,318,490,257
39956,1014,457,528,140,486,317
42224,929,359,426,106,503,253
44263,951,339,464,77,487,262
46093,1125,464,673,171,452,293
47802,1363,687,950,386,413,301
48837,1528,863,1116,573,412,368
49541,1550,831,981,526,569,305
49962,1714,891,1019,420,695,574
49719,1865,872,1147,436,718,727
48715,2032,897,1307,703,725,827
47328,1819,884,1102,580,717,654
46243,1695,876,1062,400,633,711
45467,1662,851,876,707,786,1107
42492,1135,725,594,140,541,585
38830,1088,575,579,125,509,450
35865,1093,615,592,158,501,457
33910,954,524,507,142,447,382
32579,852,457,369,121,483,336
31923,707,348,244,53,463,295
31908,621,367,159,61,462,306
33169,574,352,120,24,454,328
35033,413,248,142,3,271,245
36222,284,43,151,1,133,42
37991,252,2,76,1,176,1
40370,254,49,20,1,234,48
43252,204,31,57,1,147,30
45671,215,2,127,1,88,1
47447,431,16,313,9,118,7
49349,556,44,336,13,220,31
50793,888,521,613,83,275,438
52142,762,278,472,74,290,204
53440,971,596,472,123,499,473
53443,972,597,394,99,578,498
52451,986,553,464,67,522,486
50652,1089,553,599,139,490,414
48930,1299,838,805,353,494,485
47883,1432,911,1019,467,413,471
44582,1699,939,1272,732,427,321
40631,1887,939,1511,756,376,303
37196,2173,935,1764,1014,409,292
34965,2328,1057,1842,1365,486,308
33386,1997,934,1599,947,398,258
32475,1831,929,1571,914,260,223
32340,1479,710,1219,668,260,42
33338,1292,647,1059,579,233,68
35015,910,437,742,369,168,68
36241,462,160,353,159,109,1
38741,280,94,187,78,93,16
41673,207,47,53,34,154,13
44820,188,46,13,1,175,45
47480,181,29,41,1,140,28
49507,227,18,78,1,149,17
51508,427,155,221,1,206,154
52844,621,198,313,1,308,197
53730,772,507,443,8,329,499
54026,777,318,343,28,434,290
53101,1071,594,337,85,734,509
51570,1266,720,349,140,917,580
49645,1409,833,516,145,893,752
47876,1467,683,757,207,710,476
46719,1995,938,1345,637,650,664
43698,2154,939,1589,846,565,458
40361,2466,939,1990,1151,476,450
37191,2625,1084,2102,1441,523,357
34970,2882,1482,2340,1998,542,516
33315,2508,1152,2027,1533,481,381
32168,2342,1192,1871,1503,471,311
31561,2000,924,1591,1097,409,258
31647,1768,924,1449,1014,319,221
31982,1362,715,1149,601,213,114
32614,1102,486,968,427,134,59
35490,766,398,660,375,106,23
39364,400,159,295,158,105,1
43305,175,2,133,1,42,1
46664,141,2,62,1,79,1
49363,208,17,81,1,127,16
50970,505,118,269,1,236,117
51954,1111,564,611,97,500,467
53113,1321,788,794,240,527,548
54039,1509,882,908,428,601,470
54058,1676,925,972,600,704,489
52827,1795,951,910,694,885,655
50251,1787,933,975,529,812,562
47753,2137,946,1370,777,767,657
46203,2441,961,1771,1078,670,567
43138,2837,962,2199,1426,638,478
39800,3170,1324,2493,1836,677,512
36574,3097,1273,2472,1715,625,442
34274,3133,1455,2528,1887,605,432
32608,2840,1315,2339,1668,501,353
31433,2609,1262,2088,1534,521,272
30723,2424,1059,1987,1392,437,333
30473,2061,968,1582,1159,479,191
30399,1673,882,1365,656,308,226
30780,1373,673,1165,572,208,101
33589,1026,648,828,562,198,86
37046,536,163,305,125,231,38
40535,328,88,91,18,237,70
43384,296,105,79,2,217,103
45603,373,141,165,6,208,135
47388,577,186,216,15,361,171
48952,845,428,242,12,603,416
49734,990,805,245,27,745,832
49819,952,340,433,13,519,327
48975,1636,729,758,406,878,661
47324,1875,718,1156,278,719,440
45476,3550,936,2683,1420,867,843
44181,4372,2057,3338,3065,1034,1008
43308,3752,1491,2876,2242,876,751
40624,3553,1248,2844,1839,709,591
37234,3970,2074,3194,2733,776,659
34140,3609,1702,2997,2247,612,545
32341,3445,1828,2892,2219,553,391
31219,3404,1872,2874,2253,530,381
30616,3227,1732,2667,2045,560,313
30818,3177,1559,2690,1964,487,405
32094,3023,1436,2533,1694,490,258
33935,3222,1654,2678,1988,544,334
35634,3100,1831,2596,2237,504,406
38175,2566,1307,2162,1566,404,259
41299,2152,918,1697,819,455,152
44790,2790,1333,2081,1918,709,585
48195,1959,918,1389,919,570,434
51056,1721,888,1151,639,570,390
53586,1817,885,1229,528,588,357
55509,2249,936,1710,699,539,449
56640,2946,951,2285,1236,661,466
56378,3533,952,2752,1492,781,541
55261,4360,1697,3185,2540,1175,843
53473,4171,1730,2931,3064,1240,1334
51440,3040,989,2000,2005,1040,1016
49426,2586,939,1710,1622,876,808
48293,2496,943,1839,1332,657,592
44899,3096,1363,2470,1844,626,481
40863,3986,1882,3317,2401,669,519
37584,4864,2609,4047,3152,817,543
35483,5662,3388,4813,4128,849,740
34122,5678,3401,4887,4021,791,620
33269,5906,4123,5165,4810,741,687
33257,5322,3650,4699,4154,623,504
34352,4986,3623,4371,4093,615,470
36074,4294,2670,3768,3068,526,398
37321,4091,2638,3621,3034,470,396
39745,3868,2482,3442,2816,426,334
42932,3612,2013,3194,2263,418,250
46227,3899,2533,3432,2895,467,362
49464,3518,2220,2944,2574,574,354
52270,3136,1538,2487,2028,649,490
54437,2819,1073,2140,1551,679,478
55757,2743,956,2046,1407,697,581
56298,2626,953,1939,1285,687,570
56055,2805,953,1973,1473,832,633
55455,2926,953,2058,1447,868,716
54173,3287,984,2332,1727,955,743
52189,3565,1122,2596,1863,969,741
50701,4033,1513,3172,2317,861,804
49570,4430,2256,3571,2984,859,728
46100,4602,2390,3749,3088,853,698
42074,4796,2721,3976,3451,820,730
38704,4655,2710,3848,3293,807,583
36435,4811,2969,4077,3622,734,653
34872,4757,3131,4076,3669,681,538
33900,4730,3099,4103,3568,627,469
33783,4765,3386,4212,3852,553,466
34838,4329,3000,3841,3329,488,329
36499,3982,2634,3560,2927,422,293
37791,3723,2815,3308,3110,415,295
40370,3014,1961,2698,2182,316,221
43859,2623,1457,2300,1588,323,131
47536,2695,1794,2213,2018,482,224
50905,2044,931,1584,1116,460,279
53689,1702,880,1244,675,458,273
56018,1728,875,1159,603,569,390
57717,1774,895,1064,529,710,474
58548,1860,922,1046,407,814,578
58359,2262,934,1213,620,1049,834
57406,2527,947,1555,827,972,1050
55914,2663,947,1934,1046,729,810
54041,2966,947,2298,1569,668,680
52242,3200,1426,2595,2042,605,616
50896,3226,1307,2683,1733,543,426
47442,3971,1786,3351,2285,620,499
43373,4683,2534,3961,3105,722,571
39849,4958,3230,4162,3925,796,695
37420,4307,2576,3642,3145,665,569
35660,3921,2152,3268,2603,653,451
34481,3867,2105,3168,2579,699,474
34213,3668,1754,3009,2260,659,506
35152,3586,1995,3016,2510,570,515
36816,3009,1555,2550,1860,459,305
38056,2864,1690,2435,2063,429,373
40826,2296,1330,1883,1621,413,291
44391,1765,722,1365,589,400,133
48196,2271,955,1665,1161,606,369
51679,1951,954,1310,707,641,314
54434,1984,920,1398,735,586,492
57205,1840,879,1340,807,500,483
59335,1589,804,1147,632,442,369
60775,1681,760,1247,686,434,585
61154,1672,800,1092,703,580,424
60362,1757,794,1069,679,688,510
58675,1866,836,1151,601,715,562
56559,2119,933,1369,716,750,580
54594,2482,956,1674,1064,808,648
53024,2816,960,2025,1448,791,759
49193,2843,960,2133,1497,710,618
44948,3022,1049,2340,1602,682,553
41391,3280,1301,2628,1868,652,567
38820,3460,1546,2852,2032,608,486
37155,3751,2118,3134,2612,617,494
36065,3719,2293,3093,2774,626,481
35753,3420,1936,2859,2365,561,429
36526,3248,1926,2709,2342,539,416
37856,2734,1381,2319,1665,415,284
38891,2557,1482,2183,1721,374,239
41825,2133,1209,1869,1431,264,222
45631,1613,795,1329,708,284,87
49606,1554,951,1205,855,349,167
53226,956,402,665,283,291,119
56471,595,264,283,139,312,125
59453,561,262,165,62,396,200
61519,737,386,158,41,579,427
62569,879,573,189,31,690,604
62454,1077,571,292,85,785,656
60953,1286,623,332,170,954,793
58242,1305,655,348,134,957,789
55427,1413,699,424,151,989,785
53237,1531,763,716,203,815,720
51522,1782,858,1004,431,778,614
48233,2181,947,1524,746,657,667
44563,2432,952,1808,1257,624,541
41104,2413,952,1823,1145,590,449
38591,2636,959,2030,1186,606,399
36732,2977,960,2343,1289,634,417
35398,3624,1479,2851,2063,773,584
34535,3644,1720,2829,2392,815,672
34461,3024,1250,2361,1806,663,556
34615,2584,1048,1984,1490,600,442
35063,2050,949,1489,1091,561,368
38140,1518,906,1142,846,376,370
42452,926,245,665,194,261,51
46755,912,293,635,217,277,76
50882,688,362,469,188,219,174
54359,255,15,154,1,101,14
57226,275,92,137,10,138,82
59521,405,106,159,1,246,105
61123,783,196,388,19,395,177
61874,1758,781,994,447,764,802
61510,1505,780,847,270,658,593
59945,1471,686,682,395,789,627
57328,1386,671,443,224,943,691
55045,1500,717,488,163,1012,787
53166,1590,707,643,249,947,871
49642,1749,789,850,521,899,816
45963,1838,846,1083,629,755,643
42619,2018,929,1360,707,658,498
39785,2442,937,1805,1169,637,500
37660,2617,1031,1961,1486,656,455
36132,2549,939,1941,1328,608,389
35131,2574,913,2031,1241,543,355
34714,2766,1219,2229,1656,537,437
34500,2428,958,1999,1276,429,318
34672,2240,956,1858,1256,382,300
36948,1809,889,1411,1060,398,305
40223,1262,543,944,374,318,169
43635,1196,581,953,421,243,160
47122,971,483,747,405,224,78
50328,617,149,347,57,270,92
53040,632,318,256,74,376,244
55512,836,397,284,43,552,354
57152,1173,447,529,48,644,399
58085,2051,835,1162,421,889,836
58127,2187,851,1513,590,674,636
57028,2379,889,1674,790,705,565
55035,2819,912,2181,896,638,508
53333,3565,1129,2754,1809,811,680
52033,3724,1835,2666,2874,1058,1039
48560,3109,954,2289,1823,820,869
44651,3387,1328,2514,1933,873,605
40901,3722,1313,2817,1950,905,637
38417,4159,1883,3206,2714,953,831
36680,3786,1824,3008,2519,778,695
35734,3510,1625,2839,2090,671,465
35552,3827,1961,3132,2446,695,485
36479,3941,2226,3378,2731,563,505
38276,3541,1980,3005,2283,536,303
39304,3446,1823,2915,2177,531,354
41839,3228,1956,2808,2384,420,428
44894,2440,1219,2081,1411,359,192
48457,2164,943,1787,1114,377,183
51623,2013,945,1484,1086,529,252
53929,1686,837,1125,516,561,321
55918,1702,800,1148,416,554,384
57553,2012,950,1350,675,662,561
59000,2082,949,1409,615,673,490
59604,2739,957,1834,1292,905,830
58988,2731,947,1786,818,945,496
57389,3912,947,2814,1507,1098,881
55088,5014,1811,3727,2927,1287,1116
53149,4789,2104,3721,3165,1068,1061
51709,4216,2157,3330,3025,886,868
47666,3679,1681,2862,2255,817,574
43571,3938,2043,3106,2798,832,755
39831,3720,1964,2964,2563,756,599
37504,3803,1814,3100,2312,703,498
35968,4283,1953,3501,2411,782,458
34998,5150,2704,4234,3334,916,630
34896,5402,3086,4449,3747,953,661
35955,5203,3111,4355,3796,848,685
37868,4630,2684,3890,3171,740,487
38929,4417,2511,3763,2955,654,444
41570,4275,2444,3683,2847,592,403
44956,3999,1930,3373,2259,626,329
48562,4298,2347,3612,2887,686,540
51915,3630,1903,3036,2349,594,446
54418,3111,1444,2478,1858,633,414
56785,2767,956,2041,1359,726,492
58802,2781,956,2002,1298,779,715
60197,2727,956,1799,1147,928,700
60876,2993,965,1873,1160,1120,931
60533,3169,959,1991,1231,1178,974
59147,3456,957,2220,1396,1236,1019
57018,3978,957,2562,1967,1416,1151
55096,4270,1132,2812,2499,1458,1367
53584,4096,1048,2911,2104,1185,1056
49896,4658,1655,3398,2608,1260,953
45806,5438,2362,4140,3534,1298,1172
41998,5705,2864,4476,3960,1229,1096
39540,5704,2924,4630,3863,1074,939
37815,5924,3364,4921,4238,1003,874
36742,5968,3542,5044,4336,924,794
36455,6019,3855,5121,4607,898,752
37346,5918,3884,4979,4589,939,705
39040,5597,3378,4741,4054,856,676
40052,5577,3586,4768,4269,809,683
42693,5317,3084,4497,3642,820,558
46224,5486,2855,4454,3485,1032,630
49824,5780,3097,4639,4120,1141,1023
53245,4984,2539,3842,3496,1142,957
56075,4184,1666,3002,2686,1182,1020
58318,3580,948,2167,1885,1413,1039
60071,3271,941,1859,1248,1412,1173
61267,3276,946,1821,1203,1455,1253
61942,3322,958,1852,1215,1470,1253
61737,3564,959,2101,1499,1463,1365
60277,3721,960,2428,1565,1293,1210
57876,4163,959,2895,1766,1268,982
55899,5352,1637,3873,2882,1479,1245
54233,6012,2138,4550,3492,1462,1354
50478,6367,2912,4807,4259,1560,1347
46273,6147,2802,4433,4191,1714,1389
42621,5710,1900,4191,3125,1519,1225
40070,6331,2911,4586,4547,1745,1636
38284,5518,2436,3788,3954,1730,1518
37095,4812,1922,3134,3340,1678,1418
36714,4532,2067,2872,3624,1660,1557
37616,4025,1818,2613,3046,1412,1228
39395,3621,1616,2321,2700,1300,1084
40428,3206,1059,2081,2001,1125,942
42796,2845,952,1883,1233,962,632
45877,3152,956,2159,1331,993,756
49267,3248,948,1996,1680,1252,931
52566,2683,932,1289,1202,1394,1152
55435,1960,878,586,385,1374,1138
58231,1655,947,249,109,1406,1056
60502,1595,988,312,23,1283,1011
62023,1871,826,773,59,1098,885
62425,2471,873,1312,431,1159,995
61458,2868,905,1601,681,1267,889
58943,3764,933,2180,1653,1584,1594
56206,3339,934,1945,1249,1394,1044
54547,3559,956,2212,1400,1347,1205
52746,3631,958,2460,1611,1171,1118
49137,3702,955,2614,1416,1088,783
45205,4374,1128,3275,2156,1099,1028
41470,4421,1485,3314,2399,1107,914
39084,4097,1318,2973,2242,1124,924
37317,3900,1559,2676,2770,1224,1211
36262,2528,943,1689,1252,839,819
35976,2008,883,1114,1110,894,790
36846,1416,752,733,524,683,717
38540,1077,601,637,188,440,413
39312,1223,738,736,383,487,489
41494,1185,636,648,384,537,524
44559,1075,503,369,289,706,496
48331,1064,577,118,125,946,702
51855,1067,872,44,10,1023,882
54922,1158,832,113,3,1045,835
57790,1386,885,268,54,1118,939
59804,1740,994,463,149,1277,1143
61105,1861,862,656,221,1205,1076
61433,2060,913,849,408,1211,1036
60722,2231,938,861,665,1370,1209
58678,1973,902,1006,311,967,765
55823,2319,876,1433,616,886,743
53834,2696,943,1704,1390,992,975
52055,2096,945,1374,885,722,691
48658,1879,925,1290,614,589,445
45251,2197,950,1584,886,613,448
41648,2422,958,1835,1235,587,482
39025,2431,975,1801,1395,630,420
36997,2406,1065,1745,1612,661,547
35620,2185,957,1523,1452,662,496
34715,1996,951,1542,1122,454,400
34536,1991,962,1687,1184,304,222
34946,2060,1214,1775,1348,285,134
35301,2016,1162,1766,1290,250,128
38349,1722,947,1501,1054,221,107
42606,1321,544,1085,492,236,52
47143,1270,637,1013,531,257,106
51155,911,249,666,198,245,51
54483,893,352,620,222,273,130
57124,910,318,583,156,327,162
59190,1301,611,853,258,448,353
60544,1583,869,974,448,609,438
61268,1744,882,1009,541,735,535
61115,1797,862,970,522,827,561
59975,1918,885,1001,581,917,651
57747,1970,896,992,658,978,704
55419,2070,941,1128,807,942,856
53412,2064,953,1382,800,682,619
49791,2436,960,1869,1157,567,454
46110,3089,1463,2457,1919,632,456
42378,3381,1548,2721,1961,660,413
39548,3787,1985,3257,2480,530,495
37346,3822,2478,3375,2801,447,323
35660,3656,2499,3309,2750,347,251
34485,3430,2355,3063,2544,367,189
33929,3256,2243,2910,2491,346,248
33965,2846,1723,2573,1912,273,189
34058,2656,1517,2406,1694,250,177
37096,2346,1610,2147,1765,199,155
41503,1620,898,1459,914,161,58
46141,1121,490,1020,475,101,15
50424,737,345,689,344,48,1
53886,533,148,432,133,101,15
56515,770,162,549,77,221,85
58493,1158,474,676,196,482,278
60005,1312,580,663,177,649,403
61023,1577,856,650,207,927,775
61336,1531,806,507,139,1024,821
60449,1523,795,463,132,1060,790
58446,1829,927,611,308,1218,930
56388,2032,951,901,510,1131,986
54426,2359,958,1392,924,967,851
50563,2934,960,2026,1539,908,729
46504,3387,997,2589,1640,798,643
42524,4166,1698,3371,2350,795,652
39930,4729,2890,3718,3683,1011,793
38147,4760,3120,3938,3869,822,749
37031,4539,3041,3873,3573,666,532
36663,4137,2557,3540,2952,597,395
37299,3854,2357,3314,2742,540,385
38641,3451,1988,3030,2329,421,341
39346,2968,1765,2632,2009,336,244
42524,2383,1485,2044,1673,339,188
46834,1683,903,1321,809,362,130
51193,1365,799,1024,585,341,214
55139,916,360,612,207,304,153
58498,623,135,341,23,282,112
61414,706,220,354,42,352,178
63339,1106,550,484,125,622,425
64696,1408,738,520,175,888,667
64984,1596,849,525,179,1071,787
64658,1757,866,536,234,1221,964
63717,1853,877,581,285,1272,1024
61375,2015,902,683,438,1332,1158
59154,2201,933,826,699,1375,1098
56871,2422,934,1251,835,1171,1032
52403,2808,934,1736,1279,1072,902
47841,3276,935,2256,1722,1020,823
44176,3596,1172,2613,1930,983,758
41217,3876,1486,2949,2275,927,789
39207,3925,1753,3148,2448,777,695
37770,3969,2092,3256,2688,713,596
37281,3933,2228,3237,2798,696,570
38063,3694,2056,3027,2558,667,502
39537,3510,1862,2880,2322,630,460
40352,3204,1554,2630,1948,574,394
42951,2827,1491,2244,1893,583,402
46897,2043,925,1446,929,597,287
50936,1641,905,1068,552,573,383
54815,1186,564,690,210,496,354
58448,797,441,301,77,496,364
61789,599,277,212,14,387,263
64106,830,394,241,58,589,430
65467,1106,671,215,82,891,753
66039,1248,905,198,25,1050,930
65841,1345,951,209,5,1136,956
64874,1466,962,291,20,1175,982
62354,1669,845,526,116,1143,929
60177,2022,891,923,387,1099,949
57922,2602,932,1504,973,1098,931
53471,3144,933,2018,1594,1126,951
49135,3581,1019,2510,1898,1071,879
45132,3960,1319,2983,2212,977,893
42224,4263,1799,3260,2548,1003,749
40161,4576,1849,3676,2621,900,772
38713,4985,2646,4050,3409,935,763
38081,4784,2596,3877,3310,907,714
38772,4480,2241,3719,2873,761,632
40170,4399,2485,3750,3058,649,573
40892,3972,2311,3365,2733,607,422
43617,3488,2227,2822,2728,666,501
47253,2508,1001,1877,1358,631,357
51248,2037,928,1558,920,479,403
55123,1434,911,1011,718,423,265
58643,713,209,298,48,415,161
62005,588,240,174,7,414,233
64506,906,483,277,13,629,470
66065,1247,715,431,17,816,732
66746,1652,851,575,152,1077,982
66418,1819,916,591,248,1228,934
65345,2030,919,738,336,1292,1115
62731,2289,929,1005,590,1284,1095
60553,2744,933,1479,1058,1265,1098
58147,3285,932,2155,1443,1130,964
53682,4069,1236,2937,2255,1132,1019
49223,4579,1695,3558,2624,1021,929
45207,5087,2247,4069,3127,1018,880
42369,5496,2911,4439,3838,1057,927
40218,5323,2898,4366,3775,957,877
38799,5072,2845,4196,3590,876,745
38268,4994,2892,4133,3577,861,685
39058,4877,2714,4077,3360,800,646
40568,4801,2759,4002,3344,799,585
41226,4552,2531,3756,3098,796,567
43593,4145,2457,3304,3051,841,594
46979,3349,1518,2512,2071,837,553
51033,2792,1034,2090,1675,702,641
54755,2121,935,1425,1148,696,468
58307,1623,691,946,355,677,336
61682,1972,921,1067,388,905,606
64067,2420,930,1239,646,1181,1008
65486,2514,927,1231,671,1283,1113
65963,2738,927,1260,935,1478,1353
65591,2749,947,1207,966,1542,1371
64280,2829,940,1355,1091,1474,1366
61589,2980,952,1635,1261,1345,1216
59365,3308,949,2011,1601,1297,1129
57114,3847,949,2724,1931,1123,1052
52977,4744,1779,3602,2745,1142,966
48905,5546,2334,4445,3301,1101,967
44978,6321,3105,5099,4105,1222,1000
42165,6640,3507,5351,4568,1289,1061
40044,6509,3444,5333,4480,1176,1036
38699,6229,3361,5041,4254,1188,893
38077,6097,3265,4971,4229,1126,964
38640,5664,3186,4677,4029,987,843
39936,5180,2980,4246,3688,934,708
40639,4561,2507,3736,3165,825,658
43221,3944,2211,3191,2849,753,638
46933,3168,1191,2351,1596,817,405
50868,3268,1281,2405,2114,863,833
54542,2488,947,1728,1446,760,623
57888,2207,951,1484,882,723,530
60967,2497,952,1615,831,882,581
63304,3239,950,2116,1275,1123,932
64872,3602,950,2396,1488,1206,1000
65397,4065,950,2727,1836,1338,1041
64725,4572,1111,3066,2395,1506,1284
62717,4615,1214,3112,2541,1503,1327
59914,4630,1386,3168,2606,1462,1220
57757,4928,1903,3446,3238,1482,1335
55684,4985,1940,3681,3053,1304,1113
52250,5602,2411,4382,3473,1220,1062
48573,6229,3053,4960,4081,1269,1028
45117,6542,3301,5274,4347,1268,1046
42555,6771,3898,5524,4999,1247,1101
40410,6441,3801,5319,4756,1122,955
38795,6101,3653,5060,4484,1041,831
37697,5785,3402,4721,4157,1064,755
37374,5407,3063,4448,3829,959,766
37415,4907,2895,4015,3596,892,701
37506,4289,3014,3273,3776,1016,762
40605,3041,1123,2371,1686,670,563
44533,2809,959,2135,1062,674,332
48487,3528,1389,2475,2109,1053,720
51945,2819,957,1851,1404,968,836
54869,2238,943,1309,722,929,722
57255,2183,934,1181,562,1002,820
59109,2211,925,1074,502,1137,865
60389,2389,935,1166,506,1223,1002
61097,2731,944,1389,789,1342,1144
61021,2910,954,1534,934,1376,1165
59735,3158,955,1762,1139,1396,1138
57440,3441,956,2079,1418,1362,1144
55531,3787,957,2579,1947,1208,1167
53745,3941,1451,2937,2453,1004,1002
50365,3990,1700,3137,2438,853,738
46561,4257,2118,3467,2848,790,730
43241,4134,2215,3387,2817,747,602
40629,4065,2259,3395,2794,670,535
38705,3888,2111,3304,2537,584,426
37163,3836,2231,3280,2619,556,388
36100,3480,2135,2957,2490,523,355
35591,2693,1796,2279,2054,414,258
35309,1729,959,1430,1073,299,114
35274,1157,721,979,665,178,56
38047,858,464,766,449,92,15
41988,776,456,562,431,214,25
45928,503,223,275,172,228,51
49655,478,202,222,95,256,107
52333,567,212,305,53,262,159
54087,857,251,534,50,323,201
55836,1327,617,794,268,533,349
56923,1461,747,750,320,711,427
56938,1562,720,775,249,787,471
56407,1785,866,944,316,841,550
55387,2013,945,1246,470,767,569
53593,2300,950,1550,853,750,573
52402,2351,949,1713,1205,638,593
50992,1958,943,1574,790,384,300
47567,2152,947,1799,1120,353,242
43779,2148,949,1745,1048,403,184
40452,2415,993,2033,1248,382,255
38083,2505,1015,2215,1225,290,210
36510,2836,1523,2523,1733,313,210
35658,2773,1508,2497,1703,276,195
35632,2803,1695,2578,1892,225,197
36690,2603,1620,2419,1771,184,151
38402,2321,1468,2139,1587,182,119
39556,1865,1117,1694,1227,171,110
42002,1276,924,1191,1008,85,84
45559,563,193,526,192,37,1
49900,260,28,240,27,20,1
53800,159,5,120,4,39,1
57236,192,35,103,1,89,34
60382,313,43,135,3,178,40
62553,678,364,429,13,249,351
64157,691,155,362,20,329,135
64375,1059,522,562,87,497,435
63356,1218,760,698,225,520,535
61709,1231,670,735,315,496,355
59490,1268,664,780,372,488,292
57838,1412,753,929,485,483,268
55647,1740,892,1311,631,429,261
51463,2463,948,1993,1251,470,303
47110,3030,1292,2525,1598,505,306
43403,3581,1825,3092,2204,489,379
40781,3694,2192,3242,2535,452,343
38862,3549,2159,3094,2461,455,302
37585,3525,2211,3080,2554,445,343
37210,3433,2061,2976,2358,457,297
38045,3415,2073,2970,2426,445,353
39626,2945,1760,2626,2054,319,294
40436,2381,1325,2180,1506,201,181
42984,1841,1194,1712,1299,129,105
46838,1487,1503,1380,1625,107,122
51636,769,435,741,380,28,55
56053,591,388,519,376,72,12
59669,745,793,523,873,222,80
62654,923,747,542,671,381,333
64362,907,471,453,156,454,315
64671,918,416,423,72,495,344
64341,1119,583,587,132,532,451
63072,1372,786,790,295,582,491
61527,1458,867,878,433,580,447
59058,1600,908,961,607,639,480
57301,1664,902,1064,637,600,462
55195,1834,916,1253,703,581,375
51002,2404,923,1760,1119,644,423
46725,2959,1008,2316,1474,643,466
43109,3507,1494,2829,1907,678,413
40575,3992,1926,3357,2395,635,469
38739,4255,2673,3655,3156,600,483
37460,3680,2389,3185,2705,495,316
37061,3379,3683,3005,4181,374,498
38102,2234,2965,2047,3265,187,300
39730,1504,1388,1416,1475,88,87
40525,1291,876,1231,922,60,46
42739,1051,725,999,688,52,37
46148,840,457,757,429,83,28
49585,743,581,610,533,133,48
52318,498,147,288,146,210,1
54873,352,158,106,39,246,119
57399,575,310,188,28,387,282
59139,840,362,332,28,508,334
60227,945,373,430,42,515,331
60528,1212,611,460,302,752,610
59980,1088,536,440,98,648,438
58531,1370,616,525,239,845,592
56511,1444,677,572,318,872,772
54925,1503,797,839,371,664,444
52971,1831,867,1120,641,711,402
49233,2131,905,1511,845,620,508
45087,2122,904,1646,1002,476,399
41533,1980,905,1536,989,444,267
38907,1853,907,1357,964,496,237
37112,1577,892,1170,735,407,263
35956,1538,914,1213,1126,325,212
35701,1303,832,1070,909,233,131
36712,1221,773,1045,814,176,122
38614,1215,749,1073,829,142,91
39423,1001,631,909,564,92,67
42024,831,605,758,573,73,32
45970,581,337,490,336,91,1
50295,332,38,260,36,72,2
54468,297,44,194,31,103,13
58138,292,90,111,23,181,67
61594,449,158,160,14,289,144
64127,725,311,238,17,487,294
65740,988,469,319,26,669,443
66294,1264,697,606,45,658,652
65652,1338,563,836,165,502,398
64104,1722,928,1138,560,584,463
61590,1644,921,966,536,678,411
59910,1704,921,1085,558,619,648
57455,1694,905,1204,602,490,396
53239,1984,911,1419,785,565,319
48777,2480,946,1846,1156,634,413
44990,2655,952,2064,1383,591,446
42263,2496,1135,1912,1578,584,443
40115,2073,983,1660,1317,413,334
38691,1712,861,1393,1011,319,215
38092,1554,868,1233,999,321,199
38768,1349,819,1113,790,236,172
40122,1285,804,1156,796,129,101
40597,1135,432,1043,393,92,39
42948,1453,691,1299,650,154,41
46484,1628,818,1405,906,223,88
50418,1438,797,1170,730,268,67
54325,1287,670,1037,596,250,74
57849,1151,383,946,328,205,55
61008,1519,748,1188,575,331,173
63306,1777,869,1288,691,489,341
64435,2028,907,1253,731,775,477
64433,2204,928,1387,702,817,634
62722,2358,941,1531,795,827,662
59420,2502,948,1597,968,905,752
55969,2490,952,1650,1216,840,897
53693,2261,954,1511,1195,750,798
51227,1989,954,1304,675,685,412
47621,2485,954,1735,1114,750,608
43745,2704,956,1888,1590,816,640
40406,2525,955,1757,1473,768,657
37807,2252,950,1632,1244,620,504
35974,2178,954,1575,1182,603,389
34620,2082,953,1528,1034,554,385
33773,1934,945,1402,943,532,356
33681,1670,898,1205,649,465,283
34052,1607,806,1264,583,343,223
34364,1648,887,1366,765,282,143
37062,1361,618,1201,558,160,60
40714,1172,468,961,454,211,14
44826,871,237,728,212,143,25
48897,742,194,623,190,119,4
52555,545,149,414,148,131,1
55520,405,150,130,21,275,129
57949,517,272,125,8,392,264
59595,759,428,196,30,563,418
60444,1033,572,302,46,731,526
60359,1311,756,463,86,848,670
58993,1535,863,684,222,851,641
56514,1997,937,1045,596,952,647
54616,2764,939,1769,1357,995,917
52335,3120,940,2322,1451,798,651
48976,4050,1613,3125,2269,925,656
45111,4753,2163,3767,2992,986,829
41741,4907,2426,3930,3250,977,824
39119,4868,2451,3946,3217,922,766
37161,4794,2570,3908,3260,886,690
35753,4631,2379,3863,2997,768,618
34833,4769,2688,4080,3217,689,529
34466,4750,2869,4094,3335,656,466
34470,4499,2781,3882,3214,617,433
34405,4026,2420,3450,2822,576,402
36805,3327,2063,2927,2398,400,335
40588,2617,1744,2118,1935,499,191
44764,1902,918,1515,941,387,191
49002,1606,780,1253,631,353,149
52982,1545,923,1025,627,520,309
56259,1316,642,694,244,622,398
58715,1330,715,538,186,792,529
60273,1400,642,492,215,908,692
61315,1534,682,540,243,994,782
61281,1657,749,597,282,1060,720
59472,2042,906,940,435,1102,849
56689,2241,886,1451,524,790,689
55050,2886,910,2011,1040,875,567
53020,3914,1340,2601,2325,1313,985
49340,3722,1004,2429,1976,1293,972
45468,3556,947,2532,1822,1024,922
42270,3427,1145,2791,1950,636,805
40140,3416,1481,2837,2138,579,657
38738,3197,2306,2745,2937,452,631
37907,2430,1166,1810,1463,620,297
37709,2277,930,1782,1129,495,356
38725,2278,1116,1846,1554,432,438
40426,1736,801,1364,680,372,121
41144,1984,687,1656,557,328,130
43330,2929,1444,2335,1758,594,314
46997,2430,1056,1757,1443,673,387
50946,1861,805,1350,1074,511,454
54616,1283,788,1004,610,279,288
57594,997,457,671,316,326,141
60390,1139,510,724,181,415,329
62652,1384,755,708,327,676,428
64021,1589,875,734,354,855,730
64416,1578,836,650,244,928,754
63660,1692,892,712,198,980,794
61713,1870,922,760,297,1110,821
59073,2114,943,1017,469,1097,881
57408,2441,950,1326,888,1115,916
54650,2584,950,1509,1136,1075,969
50373,2549,949,1550,1146,999,849
45854,2669,950,1656,1445,1013,923
42141,2609,951,1680,1435,929,839
39546,2471,950,1863,1524,608,754
37648,2183,1045,1680,1468,503,423
36464,1948,950,1551,1185,397,319
36155,1827,947,1478,1015,349,214
37131,1981,1058,1598,1254,383,196
38914,2045,1154,1633,1379,412,225
39544,1929,936,1536,1029,393,196
41910,1873,939,1431,975,442,219
45589,1865,938,1310,949,555,336
49754,1667,789,1193,514,474,275
54075,1920,939,1367,711,553,344
58033,2142,940,1544,597,598,347
61416,3058,941,2094,1225,964,614
63980,3557,941,2376,1607,1181,996
65285,3531,940,2320,1557,1211,1050
65502,3568,941,2347,1513,1221,1011
64794,3795,941,2505,1602,1290,1084
62493,4015,941,2632,1748,1383,1145
59806,4337,941,2817,2175,1520,1305
57926,4424,1072,2946,2355,1478,1283
54935,4498,1170,3145,2272,1353,1102
50570,4977,1611,3612,2715,1365,1104
46050,5355,1963,4066,3119,1289,1156
42266,5452,2375,4241,3455,1211,1080
39660,5183,2494,4141,3413,1042,919
37620,4851,3050,4077,4018,774,968
36436,3850,2456,3253,3049,597,593
36042,3462,2235,2763,2766,699,531
36947,3238,1643,2527,2165,711,522
38864,3584,1654,2785,2136,799,482
39579,4184,1832,3290,2518,894,686
41139,4588,2095,3466,2889,1122,794
44054,4717,1581,3449,2497,1268,916
47336,5032,1417,3615,2474,1417,1057
50506,5427,1516,3839,2827,1588,1311
53316,5125,1376,3500,2750,1625,1374
55861,4564,941,2899,2387,1665,1493
57888,3815,935,2326,1609,1489,1346
59695,3521,939,2075,1374,1446,1293
61008,3391,937,1988,1218,1403,1224
60893,3493,940,2026,1369,1467,1290
59303,3505,942,2114,1330,1391,1194
56792,3915,945,2505,1746,1410,1249
55323,4324,1007,2789,2349,1535,1342
53151,4545,1062,3067,2333,1478,1271
49485,5185,1394,3832,2590,1353,1196
45292,6213,2533,4692,3850,1521,1317
41938,6357,2679,4850,4002,1507,1323
39660,6252,2819,4741,4080,1511,1261
38158,5833,2623,4400,3803,1433,1180
37266,5333,2278,4048,3325,1285,1047
36939,5120,2315,3918,3283,1202,968
38032,4688,2229,3556,3135,1132,906
40272,3976,2404,3048,3505,928,1101
40715,2587,1219,2085,1693,502,474
42518,2224,884,1692,1112,532,267
45537,2396,919,1533,1067,863,379
49043,2457,918,1284,1105,1173,729
52047,1967,876,682,631,1285,897
54283,1494,757,311,123,1183,847
56284,1426,862,265,85,1161,947
57828,1555,960,410,47,1145,1007
58989,1754,856,641,138,1113,994
59419,2089,917,882,334,1207,937
58955,2455,931,1187,523,1268,1026
57492,2705,937,1487,719,1218,1028
55294,2900,936,1716,1066,1184,1099
54135,2779,948,1717,1247,1062,1035
52213,2515,950,1673,1075,842,790
48597,2584,953,1757,1276,827,695
44632,2678,953,1844,1634,834,808
41435,2389,951,1674,1415,715,650
39061,2316,950,1573,1469,743,596
37235,2224,944,1581,1472,643,660
36248,1908,943,1421,965,487,398
35980,1980,932,1527,1212,453,307
37047,2004,1064,1574,1303,430,239
38982,1859,1152,1407,1331,452,179
39764,1502,866,1066,870,436,132
41899,1227,718,788,550,439,168
45285,948,386,501,238,447,148
48932,941,516,399,198,542,318
52554,805,453,170,84,635,369
55858,690,424,55,32,635,456
58724,699,448,59,1,640,449
60665,888,419,232,8,656,411
62015,1369,371,770,43,599,328
62382,3003,851,1912,1008,1091,1014
61508,2904,910,1817,1014,1087,897
59290,2899,909,1548,1186,1351,985
56445,2849,930,1739,817,1110,829
54871,3393,953,2154,1384,1239,1016
52582,3468,953,2257,1854,1211,1214
49158,2936,953,1921,1442,1015,921
45284,2624,952,1711,1039,913,676
42003,2681,942,1881,1044,800,643
39439,3006,949,2068,1614,938,702
37469,2816,963,1945,1654,871,691
36072,2378,944,1753,1108,625,480
35240,2438,947,1883,1318,555,403
35153,2343,1032,1810,1366,533,334
35577,2227,990,1790,1344,437,354
35766,2007,1115,1679,1450,328,335
38082,1599,1068,1151,1301,448,233
41303,1170,600,627,361,543,239
44472,1229,534,694,222,535,312
47191,1487,716,864,330,623,386
49407,1898,917,1096,757,802,829
50813,1780,903,810,441,970,595
50864,1912,833,758,363,1154,988
50108,1962,838,662,383,1300,1211
48980,1800,955,526,245,1274,1200
47804,1803,874,800,209,1003,1083
46011,2081,877,929,534,1152,978
44310,2176,879,1299,414,877,770
43588,2634,897,1647,925,987,801
42373,2938,930,1873,1138,1065,771
40025,3127,942,1976,1341,1151,944
37378,3292,942,1850,2015,1442,1229
34988,2530,928,1225,1053,1305,943
33227,2287,910,1113,795,1174,932
31852,1973,903,943,618,1030,944
30880,1578,861,757,504,821,883
30386,1000,648,589,186,411,462
30299,696,359,479,148,217,211
30584,478,152,427,82,51,70
30644,544,284,472,229,72,55
32342,499,359,429,301,70,83
34772,405,248,355,147,50,101
37127,345,196,296,142,49,54
39583,371,104,254,52,117,52
42311,479,188,287,43,192,145
45076,689,275,273,62,416,213
47591,931,504,512,73,419,431
49635,973,314,555,85,418,229
51062,1311,503,917,202,394,301
51392,1708,847,1215,760,493,395
50191,1577,892,1039,747,538,434
48176,1377,841,779,486,598,355
47116,1375,897,861,635,514,449
45218,1174,673,887,482,287,191
41812,1322,877,1041,769,281,154
37882,1285,721,1023,618,262,103
35099,1361,833,1119,701,242,132
32982,1306,773,1129,663,177,110
31718,1152,545,990,476,162,69
31066,1066,526,907,450,159,76
31154,897,409,832,342,65,67
32402,664,148,630,143,34,5
34670,709,213,608,212,101,1
35496,587,109,493,97,94,12
37721,485,84,397,64,88,20
40859,333,10,229,9,104,1
44456,283,17,176,1,107,16
47923,359,97,182,3,177,94
51053,357,108,146,11,211,97
53938,507,263,141,15,366,248
56212,633,509,145,2,488,511
57768,637,366,160,3,477,363
58401,847,545,227,43,620,502
57863,882,480,316,57,566,423
56011,957,502,535,116,422,386
53225,1201,620,839,337,362,283
51615,1645,945,1183,817,462,352
49040,1913,949,1375,1000,538,328
44829,2375,952,1748,1343,627,446
40531,2751,1087,2126,1554,625,467
37151,3021,1259,2523,1666,498,407
34870,3368,1764,2825,2084,543,320
33293,3426,2437,2808,2878,618,441
32298,2716,1627,2332,2086,384,459
32275,2226,1290,1943,1520,283,230
33452,2289,1569,2013,1808,276,239
35629,2091,1531,1785,1748,306,217
36341,1664,846,1412,913,252,189
37536,1587,836,1395,800,192,165
39579,1826,1008,1584,1173,242,165
42143,1706,836,1431,1009,275,173
44568,1607,836,1260,657,347,179
46596,1652,837,1159,631,493,206
48385,1958,846,1310,734,648,425
49649,2263,860,1468,930,795,499
50164,2582,895,1683,1075,899,681
50180,2473,926,1577,1004,896,744
49511,2343,945,1559,949,784,797
48056,2201,948,1576,914,625,596
46158,2191,950,1618,877,573,368
45882,2517,953,2039,1257,478,409
44212,2695,1297,2259,1653,436,356
41007,2706,1371,2207,1717,499,346
37348,2605,1162,2104,1553,501,391
34502,2441,1137,1965,1494,476,357
32638,2165,1107,1784,1342,381,235
31389,1955,1015,1686,1174,269,159
30748,1843,968,1622,1072,221,104
30793,1849,965,1675,1078,174,113
32220,1843,939,1617,1017,226,78
34565,1922,911,1666,1062,256,151
35365,1855,849,1628,933,227,171
36967,1870,824,1639,944,231,142
39476,2054,1008,1805,1191,249,183
42655,1949,915,1609,1041,340,126
45933,1793,886,1499,714,294,172
48655,1988,922,1624,825,364,218
51419,2197,916,1686,1069,511,366
53653,2176,901,1594,1075,582,530
55238,2130,902,1413,882,717,568
55937,2366,911,1595,1023,771,669
55127,2604,934,1945,1235,659,651
53365,2844,943,2309,1510,535,583
50771,3037,1196,2514,1654,523,458
49672,3407,1622,2821,2094,586,472
47396,3650,1775,3096,2166,554,391
43385,4186,2205,3554,2588,632,383
39357,4725,2597,3974,3072,751,475
36200,5002,2976,4148,3550,854,574
34198,5023,3157,4177,3743,846,586
32920,5253,3904,4334,4508,919,604
32212,5210,4061,4315,4691,895,630
32395,5105,4000,4292,4599,813,599
33723,4867,3258,4202,3780,665,522
36199,4609,2807,4053,3253,556,446
36694,4441,2934,3870,3358,571,424
38416,4231,2571,3736,2962,495,391
41578,3823,1907,3319,2221,504,314
44836,4050,2124,3529,2524,521,400
47926,3969,2118,3540,2491,429,373
50765,3729,2195,3346,2524,383,329
53539,3293,1823,2845,2194,448,371
55448,2895,1238,2324,1624,571,386
56821,2856,981,2247,1467,609,486
57388,3106,1124,2343,1828,763,704
56754,3076,956,2297,1691,779,735
54742,3068,952,2136,1518,932,596
52189,3568,1190,2458,2059,1110,869
51176,3698,1269,2731,2091,967,822
48996,4113,1610,3176,2393,937,783
45376,4576,2011,3651,2698,925,687
41503,5259,2569,4242,3345,1017,776
38386,5592,2912,4462,3779,1130,867
36223,5513,2995,4429,3934,1084,939
34533,4970,3200,3883,4130,1087,930
33593,3876,2194,2990,2998,886,804
33471,3281,1991,2651,2726,630,735
34817,2537,1290,2124,1625,413,335
37107,2529,979,2162,1220,367,241
37930,3050,1372,2635,1660,415,288
39520,3425,2063,2890,2449,535,386
42002,3003,1326,2367,1701,636,375
45103,2892,1082,2170,1523,722,441
48301,2760,955,2049,1337,711,493
51239,2744,949,1873,1298,871,571
53584,2862,952,1688,1254,1174,855
55281,2801,946,1555,891,1246,1082
56585,2946,927,1526,895,1420,1161
57308,3269,941,1950,1070,1319,1344
56792,3723,948,2042,2048,1681,1617
54578,3397,956,1810,1444,1587,1450
51969,3459,953,2190,1110,1269,1080
51091,4649,1015,3328,2244,1321,1229
49187,5520,2152,4124,3444,1396,1292
46177,5700,2407,4265,3571,1435,1164
42826,5809,2244,4451,3368,1358,1124
39752,6549,3065,5186,4300,1363,1235
37647,6534,3407,5170,4558,1364,1151
36078,6327,3207,4985,4309,1342,1102
35009,6360,3507,5021,4687,1339,1180
34442,5828,3123,4524,4107,1304,984
34786,5509,2984,4253,4046,1256,1062
35621,5157,3109,3955,4174,1202,1065
36080,4557,2373,3696,3273,861,900
38172,4319,2228,3321,2870,998,642
41185,4364,1656,3237,2456,1127,800
44492,4591,1521,3355,2484,1236,963
47424,4618,1467,3156,2564,1462,1097
49867,4326,954,2761,2126,1565,1266
51670,4081,952,2507,1701,1574,1337
52895,4018,952,2496,1521,1522,1328
53784,4257,954,2650,1885,1607,1476
53725,4176,953,2648,1821,1528,1391
52952,4296,954,2773,1755,1523,1228
51407,4702,956,3119,1949,1583,1270
49412,5343,1245,3770,2836,1573,1591
49120,4990,1435,3688,2617,1302,1182
47526,5169,2056,3854,3268,1315,1212
44999,4853,1834,3748,2921,1105,1087
42054,4811,1902,3698,2777,1113,875
39190,5138,2301,3845,3325,1293,1024
37081,4829,1840,3574,2830,1255,990
35460,4873,2189,3575,3349,1298,1160
34381,4191,2064,3101,3041,1090,977
33570,3291,1604,2538,2278,753,674
33502,2501,1215,1936,1564,565,349
33856,2213,1118,1738,1435,475,317
33805,2051,918,1554,995,497,240
36037,2024,908,1544,873,480,314
39386,1980,896,1368,700,612,277
42855,2177,867,1425,795,752,472
46196,2127,886,1358,750,769,651
48632,1815,847,1014,532,801,626
50341,1641,813,794,353,847,716
51454,1432,675,690,155,742,520
52408,1723,764,1024,218,699,546
52877,2132,886,1375,404,757,549
52562,2840,907,1785,1106,1055,778
51155,2772,926,1703,1009,1069,822
49522,2830,924,1778,1191,1052,773
49330,2686,947,1712,1164,974,802
47197,2622,947,1629,1687,993,938
43454,1931,916,1174,897,757,643
39610,1637,865,948,708,689,526
36198,1476,861,883,708,593,497
34143,1103,653,666,392,437,261
32882,870,401,557,262,313,139
32182,711,405,506,281,205,124
32296,609,366,496,280,113,86
34026,535,262,460,235,75,27
37836,507,212,434,184,73,28
38163,465,237,373,217,92,20
39574,382,210,287,185,95,25
42847,280,71,237,65,43,6
46385,230,8,225,7,5,1
49867,270,77,218,33,52,44
53030,377,69,249,12,128,57
56007,624,198,468,42,156,156
58068,798,179,641,57,157,122
59358,1318,612,992,416,326,196
60269,1619,847,1112,781,507,347
59909,1549,861,1058,706,491,367
58154,1396,831,922,617,474,312
55658,1282,853,762,673,520,348
54673,909,521,555,290,354,231
51735,810,402,603,266,207,136
47153,784,472,600,352,184,120
42684,677,470,497,336,180,134
39149,618,406,374,283,244,123
36800,576,270,351,173,225,97
35351,519,109,318,50,201,59
34497,673,133,431,55,242,78
34486,810,209,554,110,256,99
36112,912,283,605,187,307,96
39268,1040,436,663,238,377,198
39835,1035,437,721,189,314,248
41034,932,430,701,246,231,184
43918,831,341,588,234,243,107
47588,653,55,460,46,193,9
51334,1141,272,895,196,246,76
54345,1903,914,1525,774,378,183
56932,2405,1069,1981,1376,424,307
58801,2380,1036,1991,1305,389,269
59826,2418,1261,2054,1553,364,292
60092,2161,1003,1746,1184,415,181
59366,2190,899,1826,1126,364,289
57516,2170,943,1855,1175,315,232
55353,2052,1196,1903,1416,149,220
54635,1634,1301,1470,1332,164,31
51913,1234,601,1092,562,142,39
47547,1200,643,1061,577,139,66
43071,1131,610,948,530,183,80
39537,1075,442,807,366,268,76
37122,1207,696,938,483,269,213
35526,1092,530,777,374,315,156
34554,1142,453,782,292,360,161
34469,1199,666,804,391,395,275
35843,1101,649,763,333,338,316
38830,925,409,518,224,407,185
39166,912,459,401,146,511,313
40264,727,416,354,59,373,357
43107,534,208,274,39,260,169
46657,427,68,310,2,117,66
49982,596,59,482,27,114,32
53010,1096,386,799,295,297,91
55791,1564,844,1090,680,474,308
57916,1507,861,1020,556,487,305
59497,1529,850,987,545,542,305
60578,1561,888,1045,591,516,340
59893,1521,839,1032,554,489,285
57950,1504,839,1014,576,490,263
55567,1475,896,1033,679,442,302
54618,1252,575,1014,377,238,198
51622,1369,695,1147,557,222,138
47065,1460,867,1153,799,307,126
42625,1301,735,948,608,353,127
39035,1302,833,844,650,458,319
36564,1079,727,694,385,385,370
34947,839,528,537,284,302,244
33996,676,355,425,199,251,156
33933,535,276,333,121,202,155
35400,507,333,332,110,175,223
38346,440,256,250,78,190,178
38805,424,200,218,30,206,170
40277,429,195,217,44,212,151
43547,336,163,119,36,217,127
47553,255,87,89,1,166,86
51186,241,11,142,1,99,10
54496,292,28,210,27,82,1
57475,505,94,317,80,188,14
59754,653,209,350,117,303,92
61360,764,340,329,104,435,236
62254,765,343,251,69,514,274
61766,854,407,213,60,641,347
59730,962,477,174,44,788,433
57270,1115,640,203,39,912,679
56250,1126,656,343,13,783,651
53280,1222,740,507,67,715,673
48909,1271,759,525,224,746,663
44733,1213,723,452,230,761,782
41163,1033,695,316,140,717,835
38890,740,394,176,36,564,358
37350,658,320,127,4,531,316
36381,725,412,123,31,602,398
36364,728,397,92,15,636,412
37872,755,424,46,23,709,447
40892,734,642,33,11,701,653
41561,546,342,24,3,522,345
42645,470,233,13,3,457,230
45321,488,296,9,1,479,297
48448,463,322,7,1,456,323
51342,400,220,23,1,377,219
54425,487,284,27,1,460,285
57671,676,509,33,1,643,510
60121,836,583,37,5,799,588
61749,997,655,41,4,956,659
62336,1234,1042,48,2,1186,1044
61657,1222,1179,53,1,1169,1180
59353,1133,945,39,1,1094,946
56317,1137,724,38,1,1099,725
54750,1405,1049,84,7,1321,1056
52099,1503,1056,273,47,1230,1103
48718,1651,827,543,186,1108,902
45422,1875,889,853,428,1022,762
42333,2172,913,1197,706,975,837
40141,2311,920,1434,962,877,680
38315,2807,926,2032,1301,775,552
37083,3684,1625,2989,2276,695,651
36279,4098,2573,3346,3091,752,518
36182,3825,2248,3189,2722,636,474
36611,3630,2089,3061,2558,569,469
36656,3225,1743,2739,2091,486,348
39056,2860,1758,2431,2113,429,355
43018,2105,948,1537,1086,568,246
47049,1787,937,1011,615,776,409
50529,1647,892,802,363,845,865
52895,1218,684,386,113,832,571
53897,1175,577,330,101,845,678
54723,1215,513,431,90,784,594
55215,1544,734,772,170,772,904
55348,1651,862,960,339,691,853
54987,1538,821,963,346,575,550
53711,1720,849,1089,396,631,453
51500,2276,967,1419,868,857,645
50706,2649,968,1751,1201,898,816
48472,3117,953,2249,1573,868,794
45510,3438,1012,2600,1631,838,619
42240,4225,1785,3223,2555,1002,770
39537,4420,2043,3385,2838,1035,795
37455,4429,2044,3467,2767,962,723
35885,4583,2584,3672,3301,911,717
34644,4231,2324,3450,2838,781,514
33854,4207,2463,3453,2952,754,489
33605,3993,2317,3287,2796,706,479
33811,3690,2004,3056,2439,634,435
33825,3463,1747,2862,2115,601,368
36397,3393,1987,2795,2423,598,436
40468,2813,1166,2190,1501,623,335
44412,2733,979,1894,1454,839,475
47952,2397,965,1536,1080,861,643
51380,1979,945,1184,666,795,617
54256,1762,913,986,394,776,542
56532,1902,913,957,398,945,665
58115,2096,935,933,377,1163,826
58938,2396,947,1029,453,1367,1160
58816,2567,963,1103,611,1464,1294
57304,2605,961,1160,692,1445,1250
54693,2622,965,1308,730,1314,1218
53360,2772,967,1617,928,1155,1022
50817,3239,967,2177,1369,1062,934
47440,3893,1072,2841,1993,1052,921
44040,4458,1707,3462,2607,996,900
40826,4814,2367,3804,3226,1010,859
38357,4715,2394,3770,3155,945,761
36529,4712,2519,3856,3300,856,781
35304,4543,2809,3750,3508,793,699
34612,4043,2426,3288,2954,755,528
34701,3835,2020,3190,2520,645,500
35496,3891,2256,3294,2707,597,451
35174,3729,2190,3174,2547,555,357
37443,3564,2207,3015,2598,549,391
41927,3119,1380,2381,1704,738,324
46482,3160,1148,2251,1722,909,574
50614,2836,969,1978,1561,858,744
54157,2234,948,1354,1121,880,633
57223,1819,908,1010,444,809,551
59579,2143,951,1058,546,1085,788
61234,2472,963,1067,674,1405,1210
62052,2575,958,945,709,1630,1555
62006,2455,952,833,544,1622,1431
60388,2516,955,950,538,1566,1396
57932,2841,959,1294,894,1547,1374
56677,3135,959,1805,1121,1330,1231
53471,4177,941,2744,2136,1433,1254
48961,4599,1242,3298,2391,1301,1149
44391,5230,1956,3862,3123,1368,1167
40723,5514,2350,4183,3549,1331,1199
38383,5441,2545,4273,3640,1168,1095
36765,5222,2764,4181,3706,1041,942
35862,4806,2498,3876,3258,930,760
35859,4672,2545,3827,3271,845,726
37336,4389,2272,3596,2862,793,590
40455,4355,2314,3546,2895,809,581
41042,4212,2112,3462,2672,750,560
42521,3896,2061,3200,2622,696,561
45716,3252,1516,2554,1927,698,411
49539,2812,1260,2143,1738,669,478
53270,2138,966,1463,1240,675,398
57034,1568,936,824,580,744,445
60564,1294,693,622,154,672,539
63191,1304,656,563,63,741,593
64816,1647,959,652,101,995,1060
65409,1839,935,582,226,1257,1074
64882,1852,892,565,172,1287,989
63003,2064,913,735,252,1329,1070
60455,2399,961,1113,489,1286,1071
59234,2843,962,1727,822,1116,966
55251,3682,963,2572,1573,1110,945
50301,4573,1667,3412,2752,1161,1085
45525,4837,2080,3765,3047,1072,967
41774,5035,2447,4067,3332,968,885
39325,5097,2677,4146,3460,951,783
37539,5090,2834,4106,3640,984,806
36390,4788,2607,3818,3382,970,775
36212,4453,2278,3585,2970,868,692
37689,4281,2307,3457,2915,824,608
40843,4099,2270,3287,2811,812,541
41082,3754,1830,3062,2330,692,500
42449,3684,2392,3019,2940,665,548
45538,2793,1412,2122,1759,671,347
49348,2172,935,1581,1184,591,363
53068,1636,930,968,975,668,369
56568,978,498,470,134,508,364
60184,861,293,393,24,468,269
62874,1242,532,514,66,728,466
64525,1741,843,687,244,1054,979
65235,1786,866,734,189,1052,916
64868,2005,904,887,305,1118,858
63336,2302,927,1149,450,1153,887
60558,2758,953,1574,854,1184,1030
58957,3118,954,2056,1276,1062,929
55417,3539,953,2505,1828,1034,911
50564,3971,1526,2977,2394,994,868
45725,4107,1798,3196,2574,911,776
41866,4147,2201,3227,2999,920,798
39163,3719,2152,3130,2915,589,763
37333,2803,1836,2255,2160,548,324
36303,2475,1257,1942,1672,533,415
36061,2175,1181,1738,1573,437,392
37364,1838,996,1413,1211,425,215
40407,1638,908,1249,978,389,175
40738,1461,803,1020,683,441,120
42187,1474,899,1040,869,434,259
45395,1065,557,590,416,475,141
49235,816,269,403,133,413,136
52967,834,405,365,117,469,288
56634,702,256,174,36,528,220
60172,733,342,140,15,593,327
62816,979,497,300,35,679,532
64391,1305,659,406,120,899,779
64993,1340,672,358,109,982,682
64606,1522,708,458,124,1064,793
62908,1691,790,648,202,1043,852
60275,1841,899,862,382,979,736
58851,2164,930,1288,779,876,791
55223,2291,933,1593,875,698,504
50528,2917,1021,2114,1568,803,547
45840,3258,1244,2489,1850,769,606
41976,3546,1527,2897,2078,649,551
39484,3858,1929,3282,2333,576,404
37745,4315,2442,3800,2833,515,391
36594,4582,2949,4154,3345,428,396
36244,4419,2966,3993,3250,426,284
37523,4332,2807,3830,3119,502,312
40412,4120,2491,3682,2862,438,371
40877,3873,2760,3474,3069,399,309
42245,3191,2411,2868,2629,323,218
45548,2568,1949,2127,2129,441,180
49741,1872,908,1454,976,418,180
53757,1722,850,1313,1070,409,254
57521,1250,593,918,474,332,119
60990,1220,598,781,392,439,206
63410,1202,544,537,202,665,342
64773,1333,788,425,87,908,701
65183,1424,720,482,131,942,851
64570,1458,680,403,201,1055,838
62513,1691,789,504,344,1187,964
59353,2023,865,938,610,1085,920
57471,2468,934,1735,858,733,639
54191,3633,953,2813,1352,820,433
50321,6174,2888,4985,3856,1189,968
46139,6935,3939,5700,5064,1235,1125
42257,6973,4256,5720,5329,1253,1073
39451,7145,4624,5872,5661,1273,1037
37179,7191,4790,5871,5830,1320,1040
35522,7057,4609,5763,5703,1294,1094
34414,6686,4219,5409,5172,1277,953
34304,6358,3680,5148,4602,1210,922
34852,6082,3483,4911,4372,1171,889
34943,5404,2813,4426,3592,978,779
36341,4994,2850,4187,3557,807,707
38967,4391,2162,3706,2664,685,502
41384,4484,2070,3861,2534,623,464
43400,4840,2584,4159,3084,681,500
44863,4775,2917,4106,3535,669,618
46147,3981,2512,3426,3074,555,562
47049,3059,1789,2695,2228,364,439
47881,2418,1026,1972,1279,446,253
48290,2315,1015,1748,1333,567,318
47817,1898,940,1407,786,491,334
46069,1732,916,1304,667,428,346
44014,1664,904,1281,817,383,433
43575,1296,837,1024,746,272,282
41444,910,356,648,254,262,102
38631,944,405,552,234,392,171
35465,1013,606,551,227,462,379
32398,836,535,495,162,341,373
30269,619,218,270,61,349,157
28724,603,246,243,13,360,233
27838,592,231,217,8,375,223
27180,567,232,217,12,350,220
27060,543,207,222,18,321,189
27283,553,251,277,31,276,220
27266,498,149,280,9,218,140
29177,536,212,268,22,268,190
31887,483,220,96,2,387,218
34695,470,352,69,1,401,353
37478,463,412,18,1,445,413
40174,484,453,29,1,455,454
42670,529,607,25,1,504,608
45050,510,480,21,1,489,481
47047,528,440,17,1,511,441
48488,517,334,9,1,508,335
48686,563,431,43,1,520,432
47292,629,413,117,1,512,412
45369,659,340,208,8,451,332
44566,814,549,333,71,481,478
41793,910,525,493,104,417,421
37855,915,337,565,157,350,180
33807,1063,508,670,324,393,184
30797,1119,484,784,332,335,152
28863,1392,715,1061,538,331,177
27716,1505,763,1225,608,280,155
27178,1590,809,1344,673,246,136
27425,1760,813,1541,888,219,144
29040,1793,896,1596,1011,197,115
32393,1683,846,1521,867,162,92
33059,1671,854,1521,850,150,92
34072,1543,827,1403,751,140,76
36527,1411,933,1283,1028,128,95
39428,766,204,693,168,73,36
42270,743,227,647,183,96,44
45129,652,175,518,112,134,63
47947,612,317,407,127,205,190
50467,564,256,295,33,269,223
52620,648,243,239,18,409,225
54073,895,436,279,33,616,403
53921,1089,610,399,62,690,548
52146,1273,645,600,149,673,496
49489,1636,931,1036,475,600,516
48134,2095,940,1610,832,485,361
44837,2904,1085,2372,1409,532,324
40574,3928,1871,3296,2286,632,415
36335,4730,2499,4010,2981,720,482
33249,5314,3061,4491,3620,823,559
31280,5873,3868,4979,4546,894,678
29945,5636,3832,4768,4508,868,676
29205,5462,3739,4692,4426,770,687
29232,5512,4194,4826,4830,686,636
30786,5433,3839,4849,4311,584,472
33956,5400,3792,4833,4253,567,461
34404,5148,3423,4627,3854,521,431
35441,4947,3515,4474,3929,473,414
37728,4309,2839,3913,3177,396,338
40567,3837,2383,3465,2644,372,261
43452,3624,2216,3198,2496,426,280
46285,3408,1876,3002,2196,406,320
49152,3391,1929,2984,2258,407,329
51464,3367,1923,2851,2296,516,373
53400,3266,1597,2590,2132,676,535
54558,3222,1340,2372,2007,850,667
54243,3152,1149,2213,1831,939,682
52243,3231,1030,2357,1747,874,717
50030,3668,1669,2780,2412,888,743
49353,3849,1856,3052,2481,797,625
46574,4277,2049,3523,2619,754,570
42630,5115,2844,4261,3503,854,659
38555,5668,3378,4770,4073,898,695
35470,5952,3574,5021,4361,931,787
33603,5822,3407,5017,4126,805,719
32455,5796,3582,4989,4204,807,622
31688,5716,3687,4974,4325,742,638
31795,5352,3342,4626,3858,726,516
33418,5258,3165,4520,3703,738,538
36674,5172,3368,4391,3983,781,615
37432,4508,2937,3720,3522,788,585
38193,3765,2114,3096,2643,669,529
40872,3470,1455,2709,1853,761,398
44165,3790,1485,2916,2097,874,612
46960,3632,1490,2655,2164,977,674
49428,3122,932,2076,1589,1046,731
52029,2924,915,1545,1442,1379,1016
53658,2578,871,1080,900,1498,1148
54956,2362,828,819,598,1543,1389
56060,2492,857,926,636,1566,1290
56059,2464,917,1193,416,1271,1064
54500,2412,947,1219,415,1193,969
52307,2758,931,1444,1101,1314,1372
51562,2602,932,1648,957,954,851
48780,3443,1122,2389,2079,1054,957
44715,3505,1292,2243,2087,1262,795
40605,3950,1399,2611,2667,1339,1268
37660,3939,1860,2822,2989,1117,1129
35701,3366,1588,2551,2361,815,773
34436,3115,1479,2539,2021,576,542
33724,3075,1586,2642,1962,433,376
33869,2920,1180,2588,1363,332,183
35661,3639,1938,3024,2168,615,230
38990,3674,1692,2944,2123,730,431
39661,3572,1536,2800,2075,772,539
40351,3223,1594,2372,2160,851,566
42394,2465,929,1548,1002,917,364
44365,2680,926,1597,946,1083,638
45506,3102,941,2231,1228,871,1064
46482,2960,940,2353,1479,607,644
47376,2970,1211,2442,1693,528,482
47881,3129,1310,2631,1862,498,552
47704,3279,1343,2476,1807,803,464
46869,3824,1095,2757,1795,1067,700
45574,4735,1439,3521,2590,1214,1151
43881,4900,1900,3701,2942,1199,1042
43328,4886,1965,3700,2919,1186,954
43325,5037,2384,3924,3471,1113,1087
41489,4695,2548,3775,3652,920,1104
38317,3979,2380,3182,3151,797,771
34924,3487,1893,2804,2562,683,669
32466,3225,1635,2611,2178,614,543
30931,3132,1494,2526,1944,606,450
29848,3280,1673,2633,2175,647,502
29320,3080,1430,2559,1912,521,482
29488,2870,1426,2354,1796,516,370
31126,2654,1193,1987,1537,667,344
34361,2593,907,1781,1433,812,526
35291,2309,946,1696,1103,613,513
35479,2217,956,1616,1226,601,384
36699,1956,937,1405,858,551,329
38131,1896,935,1454,798,442,344
39310,1666,859,1254,726,412,213
40209,1546,894,1160,701,386,246
40990,1312,679,980,440,332,239
41093,1199,578,862,325,337,253
40545,1110,461,751,192,359,269
39942,1067,476,666,192,401,284
38905,1080,484,563,217,517,267
37713,1091,485,578,144,513,341
37329,1048,492,586,133,462,359
37486,897,306,510,83,387,223
36350,839,325,416,126,423,199
34482,697,224,305,49,392,175
32157,617,210,245,46,372,164
30056,555,161,178,34,377,127
28645,524,241,80,13,444,228
27680,458,195,61,1,397,194
27043,566,379,23,2,543,381
26853,629,435,15,1,614,436
27177,701,568,19,1,682,569
28140,666,528,33,1,633,529
28881,606,523,52,1,554,524
30257,509,387,32,1,477,388
32308,459,328,15,1,444,329
34149,453,319,11,1,442,320
35767,401,283,27,1,374,284
37383,336,181,83,1,253,180
38976,373,227,136,1,237,226
40389,333,121,140,1,193,120
41290,418,278,122,1,296,277
41280,356,239,95,1,261,238
40635,302,169,78,1,224,168
39566,305,170,99,1,206,169
39240,331,196,129,1,202,195
39269,356,101,221,1,135,100
37814,390,46,328,18,62,28
35571,411,44,369,39,42,5
33228,560,68,445,66,115,2
31104,652,146,548,121,104,25
29177,708,203,560,176,148,27
28045,637,118,529,93,108,25
27293,796,227,661,178,135,49
26894,884,320,732,267,152,53
26897,861,355,706,293,155,62
27409,740,325,629,249,111,76
27814,590,272,461,185,129,87
29282,425,132,337,80,88,52
31421,400,240,322,134,78,106
33379,213,153,150,40,63,113
35133,131,56,35,1,96,55
36476,130,64,33,1,97,63
37240,147,72,38,1,109,71
37670,169,74,48,1,121,73
37805,183,33,61,1,122,32
37800,197,20,63,1,134,19
37482,250,26,68,1,182,25
37028,381,88,171,1,210,87
37348,555,111,345,14,210,97
37705,745,160,547,96,198,64
36190,1185,407,987,319,198,88
33681,1693,789,1471,678,222,111
30811,2200,953,1974,1108,226,155
28601,2535,1451,2265,1610,270,159
27374,2539,1454,2333,1610,206,156
26722,2368,1377,2191,1450,177,73
26538,2368,1394,2168,1457,200,63
27012,2354,1427,2148,1532,206,105
28927,2069,1180,1901,1248,168,68
32347,1830,1146,1693,1212,137,66
33600,1373,832,1280,868,93,36
33836,877,439,826,436,51,3
35326,557,180,531,175,26,5
36963,346,75,296,63,50,12
38495,198,6,170,1,28,5
40138,150,2,110,1,40,1
41935,143,2,105,1,38,1
43440,129,2,92,1,37,1
44801,158,2,33,1,125,1
46045,214,18,13,1,201,17
46167,377,203,33,1,344,202
44935,500,317,114,1,386,316
43911,535,165,232,11,303,154
43582,740,140,563,70,177,70
41009,1301,577,1096,484,205,93
37299,1686,947,1503,942,183,136
33470,1748,911,1480,881,268,82
30758,1839,868,1510,765,329,103
28967,2350,1565,1973,1924,377,359
27917,1914,1270,1723,1473,191,203
27334,1996,1491,1879,1567,117,76
27549,2589,3152,2374,3328,215,176
29301,2562,1840,2395,2068,167,228
32697,2654,1159,2203,1230,451,71
33479,4167,3412,3744,4291,423,879
34033,2735,2895,2379,3111,356,216
35782,1817,927,1432,940,385,118
37766,2004,914,1442,971,562,275
39847,2308,954,1621,1773,687,869
41594,1545,883,969,545,576,338
43558,1618,888,839,635,779,623
45239,1256,753,561,257,695,522
46479,965,516,364,80,601,436
47169,749,444,143,21,606,423
46873,563,370,37,10,526,360
45158,452,335,24,1,428,336
43783,421,314,51,1,370,313
43435,363,90,157,6,206,84
40726,496,104,349,47,147,57
36961,718,236,589,170,129,66
33096,919,309,844,268,75,41
30337,1265,491,1196,479,69,12
28631,1805,892,1679,915,126,23
27623,2264,1221,2091,1279,173,58
27061,2708,1648,2496,1757,212,109
27237,2938,1761,2663,1885,275,124
28908,3256,1866,2879,2033,377,167
32137,3617,2200,3203,2465,414,265
32772,3603,2028,3180,2309,423,281
33090,3508,1997,3108,2288,400,291
34708,3340,2186,2950,2500,390,314
36704,2490,1054,2157,1216,333,162
38570,2713,1506,2388,1785,325,279
40394,2185,1054,1956,1263,229,209
42684,1841,928,1611,997,230,150
44730,1577,903,1350,711,227,192
46594,1335,506,1029,389,306,117
47865,1566,766,1177,520,389,246
47790,1745,920,1306,627,439,293
46140,2036,947,1570,873,466,323
44190,2639,1211,2163,1702,476,491
43435,2911,1367,2571,1725,340,358
40693,3990,2486,3579,2878,411,392
36874,4501,2712,3906,3060,595,348
32969,5148,3234,4444,3771,704,537
30166,5271,3440,4580,4020,691,580
28502,5244,3503,4581,4017,663,514
27396,5301,3794,4672,4255,629,461
26858,5131,3783,4596,4212,535,429
26968,4668,3425,4212,3760,456,335
28595,4434,3184,4067,3483,367,299
31807,4429,3073,4022,3349,407,276
32585,4507,2959,4061,3281,446,322
33175,4554,2872,4085,3224,469,352
35067,4556,3048,4101,3452,455,404
37498,3914,2214,3511,2507,403,293
39890,3869,2464,3481,2796,388,332
42506,3245,1977,2868,2257,377,280
45407,2735,1438,2365,1717,370,279
48000,2439,1145,2069,1477,370,332
50191,2074,933,1712,1097,362,285
51495,1965,936,1541,898,424,250
51031,2199,949,1655,1018,544,316
48802,2663,991,2068,1448,595,457
46834,3203,1621,2630,2112,573,491
45800,3707,1795,3108,2179,599,384
42980,4907,2640,4094,3149,813,509
38835,5966,3581,4936,4294,1030,713
34785,6420,4443,5160,5357,1260,914
31688,6471,4343,5336,5271,1135,928
29872,6441,4447,5539,5294,902,847
28532,6088,4369,5280,5035,808,666
27793,5958,4314,5123,4961,835,647
27767,5998,4418,5225,5119,773,701
29069,5650,3958,5000,4550,650,592
32225,5555,3846,4895,4348,660,502
32915,5713,3971,5081,4515,632,544
33589,5304,3713,4773,4180,531,467
35576,4573,2959,4106,3326,467,367
38150,3860,2250,3418,2560,442,310
40808,3487,2476,3034,2906,453,430
43641,2265,1111,1961,1345,304,234
46618,1732,803,1481,669,251,134
49185,1824,866,1463,952,361,217
51105,1411,730,1082,498,329,232
52062,1271,536,921,334,350,202
51487,1330,572,964,334,366,238
48906,1624,940,1262,662,362,396
46277,1873,968,1579,961,294,284
44678,2545,1256,2138,1453,407,197
41961,3639,1836,3039,2147,600,311
38995,4881,2622,4192,3157,689,535
35641,5603,3671,4881,4250,722,579
32701,5879,4346,5204,4916,675,570
30600,5540,4040,4956,4532,584,492
29154,4938,3398,4434,3787,504,389
28128,4631,3259,4103,3631,528,372
27493,4076,2661,3591,3010,485,349
27578,3674,2317,3270,2674,404,357
28378,3253,2070,2942,2357,311,287
28836,2891,1873,2638,2078,253,205
30617,2332,1708,2201,1838,131,130
33757,1491,1276,1429,1277,62,1
37096,696,179,649,178,47,1
40412,707,356,690,355,17,1
43633,323,83,304,76,19,7
46498,286,23,231,10,55,13
48952,587,163,407,79,180,84
50919,857,292,523,131,334,161
51809,1098,491,619,223,479,268
51322,1267,574,726,260,541,314
49223,1489,809,919,450,570,359
47054,1721,957,1181,773,540,413
45397,2001,968,1526,1135,475,395
42581,2402,1225,1839,1534,563,309
39703,3071,1384,2486,1755,585,371
36476,3867,1891,3256,2321,611,430
33391,4565,2506,3937,2948,628,442
31274,5056,3063,4366,3510,690,447
29686,5254,3300,4568,3810,686,510
28535,5336,3596,4762,4143,574,547
27770,4915,3446,4391,3895,524,449
27639,4374,2958,3931,3363,443,405
27861,3906,2652,3505,2993,401,341
27894,3428,2365,3105,2672,323,307
29861,2681,1829,2434,2040,247,211
33287,1880,1294,1672,1418,208,124
36896,1088,385,968,350,120,35
40524,1266,752,1108,776,158,70
43995,825,309,667,303,158,6
47134,658,150,489,102,169,48
49534,924,235,659,157,265,78
51175,1652,705,1137,487,515,218
52060,2080,942,1506,781,574,390
51842,2246,957,1576,1040,670,426
50063,2165,966,1498,1105,667,451
48527,2047,961,1415,1181,632,482
47235,2138,964,1487,1073,651,365
44231,3089,1530,2299,2061,790,531
40545,3682,1810,2976,2353,706,543
36657,4277,2365,3595,2859,682,494
33534,4769,3074,4082,3597,687,523
31570,4843,3326,4266,3815,577,489
30417,4787,3258,4322,3643,465,385
29805,5041,4001,4587,4388,454,387
29969,4865,3546,4427,3900,438,354
31802,4947,3402,4393,3743,554,341
34919,5171,3651,4654,4157,517,506
35798,4972,3598,4556,4007,416,409
36683,4647,3560,4335,3883,312,323
39388,4245,2961,3889,3187,356,226
42715,4329,2751,3862,2982,467,231
45751,4753,3413,4190,3796,563,383
48909,4374,2726,3718,3123,656,397
51849,4259,2241,3511,2739,748,498
53836,4394,2219,3547,2892,847,673
55363,4420,2183,3435,2978,985,795
55890,4422,1998,3415,2880,1007,882
54894,4412,1951,3456,2751,956,800
52333,4661,2334,3687,3195,974,861
50732,4855,2956,3812,3796,1043,840
49618,4885,2509,3914,3253,971,744
46685,5656,2822,4626,3629,1030,807
42678,6837,4202,5521,5245,1316,1043
38706,7309,4695,5912,5854,1397,1159
35806,7454,4754,6145,5929,1309,1175
33798,7539,5146,6269,6280,1270,1134
32463,7385,5021,6031,6021,1354,1000
31693,7426,4903,6103,6009,1323,1106
31759,7405,5060,6143,6114,1262,1054
33468,7426,5213,6233,6189,1193,976
36671,7268,5088,6240,5976,1028,888
37530,7095,5062,6126,5841,969,779
38030,6771,4653,5864,5422,907,769
40509,6610,4188,5635,4956,975,768
43429,6789,3971,5585,4843,1204,872
46042,7004,3911,5725,5071,1279,1160
48573,6681,3722,5404,4971,1277,1249
50975,6027,3047,4799,4259,1228,1212
52927,5597,2390,4318,3542,1279,1152
54423,5724,2322,4344,3632,1380,1310
55148,5688,2131,4281,3478,1407,1347
54243,5772,2080,4331,3394,1441,1314
51852,6213,2539,4610,4045,1603,1506
50375,6182,2796,4621,4436,1561,1640
49515,5748,2450,4374,3764,1374,1314
46712,5694,2289,4321,3274,1373,985
42968,6640,2794,5306,4071,1334,1277
39065,7192,3985,5765,5243,1427,1258
36180,7137,4157,5797,5412,1340,1255
34210,6713,3804,5385,4852,1328,1048
32942,6551,3535,5311,4581,1240,1046
32033,6628,3870,5318,4836,1310,966
32197,6498,3655,5303,4656,1195,1001
33929,6104,3462,5056,4320,1048,858
37181,5675,3169,4703,3913,972,744
37814,5296,2841,4328,3513,968,672
38269,5097,2650,4254,3378,843,728
40763,4774,2343,3859,2964,915,621
43726,4707,2063,3530,2802,1177,739
46345,4621,1791,3218,2881,1403,1090
48708,3877,965,2729,2081,1148,1116
51233,3293,931,2333,1547,960,806
53364,3150,939,2212,1317,938,700
54851,3359,956,2314,1371,1045,750
55487,3801,971,2672,1602,1129,850
54461,4203,974,3058,1812,1145,882
52110,4637,1465,3389,2511,1248,1046
50537,4577,2097,3151,3483,1426,1386
49272,3454,1149,2108,2179,1346,1030
46177,3133,965,2119,1490,1014,1001
42388,3350,1058,2485,1857,865,799
38487,3578,1741,2716,2595,862,854
35567,3446,2054,2607,2857,839,803
33623,3221,2028,2618,2610,603,582
32279,3209,1715,2708,2001,501,286
31540,3807,2235,3246,2613,561,378
31643,4081,2485,3585,2913,496,428
33285,3881,2957,3511,3332,370,375
36653,3009,2434,2772,2636,237,202
37515,2267,1322,2018,1410,249,88
37901,2199,1341,1937,1487,262,146
40064,1857,1082,1611,1189,246,107
42721,1498,755,1197,685,301,70
45231,1568,848,1099,671,469,177
47601,1464,871,1019,561,445,376
49802,1149,348,881,187,268,161
51602,1589,530,1150,355,439,175
52626,2700,824,1977,1226,723,574
52699,2635,902,1887,1456,748,827
51308,1913,865,1280,738,633,417
48967,1831,820,1295,435,536,385
48328,2337,905,1554,1169,783,615
47370,1898,933,1323,597,575,473
44803,1996,882,1530,573,466,309
41332,2646,947,2131,1281,515,448
37712,2596,941,2031,1133,565,292
34712,3004,1081,2319,1526,685,445
32853,2816,1085,2199,1536,617,451
31522,2296,944,1779,1319,517,385
30837,1687,894,1314,735,373,241
30898,1474,826,1145,844,329,193
32691,1057,680,829,619,228,158
36032,708,534,550,399,158,190
37113,466,101,356,41,110,60
37428,660,262,516,188,144,74
39377,740,229,541,160,199,69
41902,1050,464,848,303,202,161
44400,1185,446,937,360,248,86
46322,1677,685,1042,967,635,349
47707,1342,591,804,241,538,350
47927,1702,805,1031,455,671,591
47570,1852,816,1098,710,754,664
46726,1772,856,1006,530,766,567
44893,1868,867,1098,465,770,584
42814,2111,881,1383,657,728,666
42348,2349,910,1659,873,690,598
41564,2630,929,1989,1137,641,570
40078,2964,983,2327,1633,637,650
37972,2882,1002,2235,1492,647,490
35479,3043,979,2254,1554,789,575
33185,3140,965,2255,1448,885,621
31551,3440,1021,2598,1736,842,715
30480,3671,1367,2822,1976,849,609
29848,3956,1486,3195,2150,761,664
29550,4209,2056,3381,2690,828,634
29872,4090,1760,3342,2373,748,613
30815,4317,1828,3608,2409,709,581
31962,4915,2419,4146,3059,769,640
33075,5453,2793,4706,3663,747,870
34790,5690,3175,4799,4037,891,862
36103,5563,3018,4543,3851,1020,833
37127,5493,2840,4379,3746,1114,906
37456,5371,2759,4249,3841,1122,1082
37646,4860,2545,3737,3466,1123,921
37691,4286,1904,3250,2736,1036,832
37821,3995,1599,3154,2402,841,803
38166,3774,1553,2949,2066,825,513
38089,4146,1672,3092,2378,1054,706
37735,4116,1591,2923,2534,1193,943
37950,3624,951,2505,2040,1119,1113
37302,2979,941,2028,1377,951,810
36143,2973,921,2122,1807,851,1114
34347,2351,920,1539,1067,812,606
32109,2342,903,1395,893,947,657
30066,2601,891,1466,963,1135,888
28648,2748,908,1571,1047,1177,991
27647,2777,896,1606,1105,1171,1004
26984,2826,910,1715,1406,1111,1130
26564,2592,928,1664,1235,928,943
26532,2519,936,1591,1123,928,812
26942,2573,915,1592,1175,981,914
27497,2492,902,1491,1053,1001,892
28693,2398,891,1412,966,986,930
30397,2289,877,1171,890,1118,836
31668,2380,858,1026,875,1354,978
32515,2410,845,961,734,1449,1198
33197,2401,858,883,795,1518,1394
33698,2098,859,678,515,1420,1282
34088,1895,855,578,312,1317,1000
34377,1951,826,657,335,1294,1133
34523,1885,819,741,366,1144,1027
34649,1683,811,605,355,1078,846
34573,1337,725,372,195,965,774
35186,884,561,231,30,653,531
35170,625,296,192,3,433,293
33561,597,240,192,16,405,224
31072,653,275,180,24,473,251
28114,733,401,271,45,462,356
26016,738,416,326,154,412,262
24741,815,278,582,133,233,145
24014,1318,706,1025,873,293,248
23771,1148,407,928,332,220,75
24236,1747,1239,1303,1563,444,324
26051,1182,678,827,523,355,155
29402,1115,527,873,397,242,130
30388,1241,427,952,365,289,62
31036,1715,920,1431,760,284,211
32443,1668,883,1315,1062,353,186
33978,1315,610,1105,450,210,160
35424,1495,833,1347,679,148,154
36763,1642,884,1491,841,151,91
38252,1944,1110,1741,1234,203,124
39350,2136,908,1874,1027,262,134
40522,2846,1381,2501,1607,345,226
41303,3196,1514,2769,1751,427,237
40769,3637,1827,2961,2126,676,299
39488,3876,2382,3404,3116,472,734
39482,2814,1513,2466,1679,348,166
38878,3065,1583,2684,1827,381,244
36750,3447,2005,3018,2352,429,347
33631,3590,2233,3121,2661,469,428
30306,3524,2752,3003,3229,521,477
27966,2912,2109,2498,2586,414,477
26463,2408,1671,2080,2017,328,346
25554,2133,1210,1876,1494,257,284
25067,2043,1040,1798,1257,245,217
25367,2199,1252,1893,1517,306,265
27096,2156,1086,1755,1378,401,292
30516,2111,895,1622,1226,489,340
31588,2090,908,1532,1104,558,406
31654,1867,862,1313,927,554,444
32846,1588,830,1031,956,557,574
34196,974,429,635,198,339,231
35573,990,404,583,205,407,199
36919,1081,487,640,244,441,243
38605,1145,664,601,327,544,340
39994,1009,586,379,190,630,396
41029,759,354,163,20,596,334
41552,571,273,61,6,510,267
40829,487,284,26,1,461,283
39387,397,279,34,5,363,274
39216,356,53,249,11,107,42
38821,648,197,625,176,23,21
36486,1192,524,1138,515,54,9
33123,2015,1070,1872,1105,143,35
29862,2882,1537,2625,1660,257,123
27433,3851,2329,3453,2564,398,235
26162,4489,2850,3990,3204,499,354
25466,4822,3255,4194,3694,628,439
25309,5167,3839,4305,4375,862,536
25712,5601,4049,4726,4674,875,625
27345,5585,3587,4738,4129,847,542
30420,5872,3832,4924,4427,948,595
31490,6115,4265,5111,4984,1004,719
31640,5783,3899,4869,4561,914,662
32951,5320,3693,4597,4340,723,647
34729,4554,2495,3825,2900,729,405
36551,4737,2402,3847,2908,890,506
38275,4876,2520,3850,3249,1026,729
40176,4470,2009,3352,2848,1118,839
41975,4060,1357,2739,2265,1321,908
43649,4146,964,2801,2242,1345,1358
44723,3993,966,2702,1999,1291,1161
44445,4317,1055,2846,2233,1471,1178
42729,4846,1406,3229,2871,1617,1465
42305,5156,1626,3636,2944,1520,1318
41584,5907,2104,4440,3317,1467,1213
39227,7176,3444,5623,4910,1553,1466
36016,7628,4130,5942,5640,1686,1510
32497,7748,4107,5994,5627,1754,1520
29761,7887,4357,6043,5949,1844,1592
28320,7731,4128,5979,5689,1752,1561
27315,7574,3936,5823,5499,1751,1563
26824,7443,3874,5799,5422,1644,1548
27115,6997,3483,5509,4819,1488,1336
28936,6641,3316,5226,4541,1415,1225
32409,6101,3000,4702,4163,1399,1163
33387,5287,2427,3915,3529,1372,1102
33883,4536,2227,3049,3462,1487,1235
35795,3372,1000,1927,2077,1445,1077
37937,2985,858,1873,1443,1112,965
40117,3162,772,2126,1526,1036,926
42312,3355,742,2427,1621,928,889
44599,3622,967,2507,1799,1115,832
46478,3931,915,2450,2059,1481,1144
47837,3655,942,2001,1601,1654,1432
48591,3349,949,1605,1253,1744,1556
47835,2953,928,1203,866,1750,1538
46012,2668,918,963,600,1705,1462
45892,2471,918,924,472,1547,1313
45237,2479,951,1006,638,1473,1446
42907,2152,934,1027,498,1125,1142
39308,1884,920,974,398,910,792
35520,1807,930,921,444,886,759
32564,1571,900,756,337,815,718
30591,1328,759,560,228,768,531
29444,1209,563,637,178,572,385
28801,1375,626,841,288,534,338
28767,1605,821,1128,451,477,370
30410,1682,866,1191,617,491,362
33772,1599,850,1106,647,493,318
34935,1382,804,912,577,470,227
35165,1061,492,683,332,378,160
36941,870,418,552,255,318,163
39014,571,120,216,42,355,78
41102,495,222,107,3,388,219
42996,402,187,46,1,356,186
45245,444,279,41,3,403,282
47055,538,490,58,8,480,498
48112,552,487,105,15,447,502
48360,640,402,231,28,409,374
47023,899,287,518,59,381,228
44260,1620,710,1154,416,466,294
42701,2673,972,2105,1173,568,371
40849,3983,1838,3199,2371,784,533
38485,5069,2757,4036,3479,1033,722
35827,5690,3530,4510,4508,1180,978
32972,5483,3287,4351,4168,1132,881
30236,5364,3172,4241,3968,1123,796
28415,5369,3086,4389,3926,980,840
27145,5325,3157,4432,3867,893,710
26405,5436,3225,4577,3883,859,658
26009,5621,3722,4754,4421,867,699
26252,5262,3156,4468,3742,794,586
27197,5394,3315,4615,3946,779,631
27995,5147,3231,4384,3857,763,626
29286,4573,2758,3875,3308,698,550
31303,4104,2537,3512,3079,592,542
33038,3347,1758,2865,2145,482,387
34314,2926,1663,2431,2004,495,341
35297,2290,1170,1814,1504,476,334
35965,1676,940,1263,822,413,290
36460,1376,616,1038,376,338,240
36777,1347,443,1008,277,339,166
36754,1897,778,1410,555,487,223
36343,2775,909,2070,1140,705,414
35529,3548,1193,2758,1880,790,687
35575,3785,1496,3021,2070,764,574
34698,4213,1711,3422,2266,791,555
33242,5033,2524,4140,3236,893,712
31432,5288,3009,4419,3753,869,744
28849,5188,3110,4350,3811,838,701
26936,4918,2928,4002,3577,916,649
25571,4714,2535,3802,3267,912,732
24658,4529,2496,3576,3314,953,818
24104,4134,1901,2901,2762,1233,861
23899,3726,1062,2391,2118,1335,1056
24072,3435,971,2051,1662,1384,1290
24761,3026,970,1641,1286,1385,1195
25601,2825,963,1310,1106,1515,1304
26757,2505,951,966,758,1539,1401
28209,2112,903,779,339,1333,1189
29003,1974,911,670,246,1304,1157
29382,1704,901,548,100,1156,1001
29534,1486,956,377,82,1109,1038
29452,1201,875,237,4,964,879
29351,1043,728,186,1,857,729
29283,976,649,214,1,762,650
29455,952,520,284,1,668,519
29886,1010,503,321,4,689,499
30411,1046,461,384,10,662,451
32008,1240,741,427,70,813,671
31910,1180,675,331,131,849,682
30867,1187,663,315,127,872,719
28950,1133,678,231,125,902,803
26787,1010,657,182,48,828,705
25245,1007,654,158,49,849,703
24451,1029,711,108,52,921,763
24105,1070,825,122,34,948,859
24172,1014,745,146,52,868,797
24869,1023,745,153,84,870,829
26875,989,711,144,94,845,805
30058,926,682,128,77,798,759
31683,979,852,173,87,806,939
32053,770,416,175,50,595,466
32425,820,503,133,109,687,612
32569,716,469,145,44,571,513
32417,662,388,190,29,472,417
32180,630,268,304,18,326,250
32220,795,268,508,45,287,223
32274,1030,392,759,149,271,243
32439,1229,527,994,316,235,211
32556,1549,724,1326,551,223,173
32460,2089,919,1831,921,258,186
32264,2780,1386,2479,1650,301,264
33855,3191,1848,2905,2135,286,287
33894,3560,1904,3248,2141,312,237
32429,4597,2731,4069,3046,528,315
29937,5476,3222,4756,3701,720,479
27458,6184,3850,5380,4485,804,635
25714,6501,4313,5686,4965,815,652
24857,6398,4315,5659,4956,739,641
24394,6248,4273,5522,4883,726,610
24271,6117,4296,5396,4906,721,610
24628,5843,3948,5153,4533,690,585
26554,5790,3855,5076,4420,714,565
30087,5713,3624,4991,4213,722,589
31461,5596,3575,4881,4191,715,616
31260,5268,3433,4601,4014,667,581
31838,4744,3007,4112,3524,632,517
32718,4076,2126,3428,2518,648,392
33593,4230,2054,3291,2583,939,529
34497,4091,1764,3054,2531,1037,767
35504,3471,1237,2508,1953,963,716
36438,2973,874,2008,1565,965,694
37353,2601,874,1653,1148,948,764
38212,2383,902,1379,911,1004,772
38352,2280,935,1327,686,953,753
37862,2652,954,1563,1005,1089,846
38899,3068,964,2086,1321,982,907
38870,3472,966,2541,1508,931,734
37060,4407,1674,3381,2533,1026,859
34182,4732,2164,3653,3101,1079,937
31050,4399,1846,3376,2680,1023,834
28749,4186,2116,3213,3079,973,963
27380,3573,1730,2914,2479,659,749
26522,3321,1845,2672,2406,649,561
26204,3346,2013,2598,2728,748,715
26597,3149,1553,2557,2136,592,583
28483,3697,1934,3062,2585,635,651
32074,3647,1958,3006,2369,641,411
33554,3758,1993,3121,2472,637,479
33749,3605,2202,3090,2655,515,453
35091,3065,2216,2669,2535,396,319
36814,2456,2001,2088,2301,368,300
38321,1452,858,1160,907,292,94
39658,1077,531,708,394,369,137
41277,938,388,424,113,514,275
42637,918,473,274,56,644,417
43514,926,481,222,9,704,472
44018,1026,536,197,5,829,531
43367,1173,667,234,10,939,677
42211,1340,852,291,37,1049,889
42645,1300,710,363,45,937,749
41850,1378,787,454,84,924,745
39567,1554,881,533,227,1021,918
36327,1668,909,663,352,1005,826
32928,1696,875,925,504,771,847
30381,1605,861,990,587,615,436
28978,1699,816,1094,777,605,415
28133,1805,796,1229,974,576,452
27842,1774,745,1298,1005,476,361
28183,1909,908,1393,1197,516,289
30108,1914,875,1441,1163,473,288
33886,1975,931,1489,1193,486,262
35456,2140,1070,1572,1352,568,282
35721,2238,1116,1638,1448,600,332
37076,2348,1182,1505,1558,843,376
38912,2304,946,1355,1083,949,508
40492,2490,920,1396,866,1094,640
41885,3083,940,1866,1034,1217,886
43399,3660,945,2431,1293,1229,995
44657,4363,959,2938,1973,1425,1142
45760,4577,957,3082,2153,1495,1237
46002,4873,1172,3316,2495,1557,1323
45109,4898,1329,3311,2676,1587,1347
43898,4781,1494,3191,2928,1590,1434
44309,4576,1551,3197,2960,1379,1409
43643,4454,1576,3330,2671,1124,1095
41569,4953,2287,3843,3370,1110,1083
38506,5258,2538,4070,3449,1188,911
35059,5734,2543,4455,3619,1279,1076
32206,6160,3089,4779,4263,1381,1174
30522,6151,3252,4783,4401,1368,1149
29520,6058,3376,4724,4569,1334,1193
29007,5581,2925,4446,3939,1135,1014
29134,5275,2949,4229,3838,1046,889
30872,4962,2707,4049,3450,913,743
34398,4897,2565,4118,3235,779,670
35754,5114,3141,4265,3778,849,637
36036,4927,2941,4142,3628,785,687
37777,4683,2637,3947,3197,736,560
40051,4868,2444,4023,2922,845,478
41980,5716,3050,4549,3778,1167,728
43651,6035,3115,4637,4167,1398,1052
45472,5798,2703,4311,3849,1487,1146
46888,5758,2586,4258,3906,1500,1320
47920,5651,2448,4099,3747,1552,1299
48385,5613,2187,4021,3532,1592,1345
47262,5708,2254,4120,3726,1588,1472
44847,5557,2295,3943,3707,1614,1412
44147,5481,2140,3890,3590,1591,1450
42862,5605,1989,4142,3228,1463,1239
41068,6657,2760,5051,4122,1606,1362
38748,7632,3657,5902,5258,1730,1601
36019,8103,4296,6249,5966,1854,1670
33508,8082,4340,6211,5994,1871,1654
31635,8027,4337,6111,5947,1916,1610
30380,8074,4390,6108,6020,1966,1630
29624,8118,4424,6142,6162,1976,1738
29228,7977,4545,6153,6291,1824,1746
29586,7301,3973,5816,5449,1485,1476
30579,7027,3853,5591,4971,1436,1118
31652,7257,4039,5815,5263,1442,1224
33070,7349,4477,5996,5748,1353,1271
35652,6874,3897,5407,4992,1467,1095
37955,6890,3269,5128,4553,1762,1284
39736,6867,2731,5090,4255,1777,1524
41121,6676,2630,4846,4188,1830,1558
42124,6303,2078,4569,3558,1734,1480
42872,6460,2172,4606,3627,1854,1455
43194,6847,2320,4834,4038,2013,1718
42998,6772,2223,4768,4011,2004,1788
42176,6420,2155,4480,3983,1940,1828
41152,5699,1830,3829,3577,1870,1747
41734,4995,1430,3139,3140,1856,1710
41147,4519,984,2843,2485,1676,1610
39766,4242,984,2540,2491,1702,1648
37795,3657,981,2138,1891,1519,1517
35171,3329,968,2025,1493,1304,1219
32872,3581,973,2067,1963,1514,1288
30928,3776,978,2121,2497,1655,1768
29480,3420,977,1999,2081,1421,1490
28574,3075,950,1937,1438,1138,1070
28087,3170,930,2086,1339,1084,827
27856,3735,1334,2458,2771,1277,1437
27977,3138,1245,2174,2284,964,1039
28329,2805,1048,1958,1642,847,594
29475,2841,1126,2119,1749,722,623
31793,2596,1104,1815,1616,781,512
33935,2212,923,1503,863,709,404
35997,2391,901,1618,1126,773,605
38090,2162,919,1527,1060,635,549
39471,2098,934,1510,878,588,487
40203,2335,933,1599,983,736,610
41013,2497,963,1512,1098,985,788
41658,2252,958,1347,789,905,822
41546,1868,924,1066,616,802,673
40348,1546,896,820,584,726,685
40497,1049,594,618,217,431,377
39286,934,407,604,188,330,219
37074,940,410,618,274,322,136
34108,847,389,599,283,248,106
31017,707,240,509,180,198,60
28483,732,312,559,208,173,104
26879,718,316,591,255,127,61
25931,633,248,540,213,93,35
25470,628,243,577,212,51,31
25728,733,284,708,257,25,27
27472,855,545,830,498,25,47
30679,762,367,712,348,50,19
31885,768,280,689,263,79,17
31956,966,385,861,351,105,34
33130,981,386,880,343,101,43
34686,890,424,748,367,142,57
36016,669,187,566,136,103,51
37132,917,250,787,202,130,48
38398,1315,560,1118,471,197,89
39382,1492,709,1240,552,252,157
40150,1642,900,1365,705,277,195
40563,1734,936,1462,822,272,165
39888,1865,963,1554,846,311,123
38835,2295,1125,1915,1317,380,192
39505,2676,1253,2283,1456,393,203
38523,3453,1716,3034,1985,419,269
36282,4534,2957,3966,3363,568,406
33113,4985,3399,4349,3893,636,494
29820,5266,3627,4514,4131,752,504
27452,5402,3688,4715,4292,687,604
26077,5314,4061,4755,4651,559,590
25217,4738,3331,4229,3690,509,359
24906,4832,3201,4276,3673,556,472
25248,4962,3268,4399,3767,563,499
27057,5059,3518,4448,3994,611,476
30563,5046,3427,4425,3937,621,510
32148,5065,3456,4422,3978,643,522
32015,5010,3580,4328,4123,682,543
32857,4751,3641,4292,4263,459,622
33850,4039,2779,3568,3053,471,274
34584,4166,2895,3598,3258,568,363
35304,4027,2421,3510,2821,517,400
36032,4135,2328,3590,2676,545,348
36316,4710,2695,4006,3104,704,409
36484,5173,2924,4316,3537,857,613
36569,5292,2734,4294,3457,998,723
36316,5528,2626,4450,3530,1078,904
36095,5732,2922,4563,3956,1169,1034
37171,5512,2698,4489,3574,1023,876
36592,5936,3192,4937,4129,999,937
34898,6277,3763,5278,4647,999,884
32548,6524,4077,5431,4949,1093,872
29729,6796,4242,5656,5241,1140,999
27678,6912,4445,5642,5447,1270,1002
26639,6885,4261,5647,5376,1238,1115
26021,6772,4329,5654,5318,1118,989
25810,6566,4228,5550,5070,1016,842
26219,6639,4308,5564,5217,1075,909
28122,6819,4351,5650,5340,1169,989
31840,6609,3984,5494,5006,1115,1022
33445,6384,3795,5256,4718,1128,923
33366,6272,3800,5040,4743,1232,943
34688,5953,4245,4510,5521,1443,1276
36607,4479,2349,3192,3372,1287,1023
38572,4018,1934,2875,2961,1143,1027
40561,3478,1630,2402,2548,1076,918
42783,3165,1891,2028,2964,1137,1073
44726,2134,924,1386,1209,748,602
46362,1908,905,1192,1188,716,562
47295,1452,819,950,574,502,333
46806,1477,748,1019,457,458,291
44821,1794,917,1256,629,538,360
44572,2233,932,1640,865,593,423
42934,2901,936,2028,1435,873,507
40176,3590,1340,2642,2406,948,1066
36573,3250,1316,2409,2075,841,759
32787,3237,1239,2484,1847,753,608
30023,3448,1423,2682,1999,766,576
28403,3562,1449,2890,2066,672,617
27383,3637,1866,2952,2397,685,531
26849,3408,1582,2781,2049,627,467
27030,3530,1587,2950,2060,580,473
28621,3743,2271,3121,2803,622,532
31829,3097,1692,2572,2109,525,417
32852,2627,1384,2195,1687,432,303
32452,2228,1111,1807,1344,421,233
33403,1788,943,1425,1157,363,214
34458,1383,720,1128,563,255,157
35320,1067,360,872,272,195,88
36195,1132,648,789,493,343,155
37288,813,392,388,124,425,268
38196,669,379,155,16,514,363
38789,714,657,85,11,629,668
39062,649,470,49,16,600,486
38336,656,465,47,25,609,490
37164,703,519,63,22,640,541
37675,688,353,150,5,538,348
36874,1037,584,486,62,551,594
34827,1166,648,647,246,519,441
31862,1402,707,912,424,490,490
28737,1607,773,1157,558,450,447
26538,1855,842,1432,755,423,421
25281,2170,928,1735,964,435,403
24499,2563,962,2016,1266,547,449
24184,2879,1259,2188,1850,691,591
24527,2656,989,1933,1533,723,544
26278,2479,961,1730,1311,749,544
29721,2316,930,1629,1029,687,450
31105,2326,913,1732,997,594,444
30952,2375,941,1876,1150,499,470
31708,2060,914,1605,1080,455,381
32707,1544,739,1136,584,408,246
33523,1486,659,1099,597,387,259
34302,1469,750,1056,550,413,259
35350,1473,759,1031,465,442,294
36261,1519,786,1012,458,507,328
37063,1548,744,1033,398,515,346
37626,1883,922,1289,623,594,435
37315,2118,930,1480,941,638,492
35798,2162,940,1503,1229,659,527
35483,2017,941,1565,797,452,319
34273,2902,966,2362,1260,540,311
32698,4716,2284,3915,2905,801,621
30768,5868,3387,4971,4243,897,856
28470,6254,3877,5355,4703,899,826
26495,6386,3979,5445,4725,941,746
25223,6728,4358,5648,5154,1080,796
24441,6923,4568,5820,5500,1103,932
24044,6686,4519,5638,5371,1048,852
24101,6397,4375,5462,5187,935,812
24705,5933,4022,5071,4689,862,667
25914,5775,3847,4939,4493,836,646
26839,5625,3634,4773,4231,852,597
28151,5489,3576,4700,4222,789,646
29813,4931,3385,4122,3973,809,588
31506,4125,2407,3212,2960,913,553
32869,3621,1613,2668,2321,953,708
34348,3219,1077,2230,1747,989,670
35877,3217,951,2122,1511,1095,741
37476,3548,951,2319,1589,1229,937
38954,3980,963,2506,2015,1474,1196
39891,4048,971,2454,2185,1594,1439
40071,3653,973,2205,1571,1448,1168
39232,4076,980,2414,2247,1662,1524
39709,3835,980,2664,1373,1171,957
38933,5557,1908,4155,3228,1402,1320
37506,6383,2975,4883,4338,1500,1363
35577,6740,3232,5240,4574,1500,1342
33091,7078,3665,5575,5096,1503,1431
31094,7009,3723,5620,5057,1389,1334
29750,6971,3903,5640,5135,1331,1232
28768,6843,3920,5597,5087,1246,1167
27978,6697,3965,5516,5068,1181,1103
27670,6361,3590,5297,4546,1064,956
27853,6375,3720,5338,4631,1037,911
28334,6378,4022,5330,4961,1048,939
29048,6039,3737,4914,4638,1125,901
30491,5687,3132,4575,4062,1112,930
33320,5618,2990,4235,4025,1383,1035
36316,5235,1937,3675,2995,1560,1058
38924,5492,1775,3702,3239,1790,1464
41261,5073,1322,3268,2802,1805,1480
43219,4593,909,2833,2358,1760,1491
44820,4236,893,2526,2084,1710,1500
46031,3979,893,2336,1844,1643,1455
46501,3932,900,2287,1798,1645,1390
45906,4007,923,2378,1816,1629,1425
44369,4090,949,2396,2107,1694,1480
44652,4052,976,2799,1747,1253,1185
43274,4957,1593,3820,2655,1137,1062
41048,6003,2844,4800,3911,1203,1067
37982,6602,3427,5307,4462,1295,1035
34698,7128,3883,5787,5107,1341,1224
32147,7153,4227,5800,5408,1353,1181
30396,6802,4122,5503,5258,1299,1136
29220,6329,3979,5040,5108,1289,1129
28745,5499,3327,4233,4474,1266,1147
29155,4546,2561,3356,3620,1190,1059
31191,3688,2207,2457,3372,1231,1165
34645,2819,1583,1804,2541,1015,958
36503,1930,887,1372,788,558,359
36471,2525,1167,1834,1768,691,601
38147,2221,920,1493,1236,728,601
40335,2018,856,1167,681,851,474
42432,2318,804,1156,721,1162,742
43970,2708,813,1527,763,1181,1004
45374,3136,876,1967,1122,1169,1034
45888,3459,859,2168,1450,1291,970
46226,3863,872,2394,1741,1469,1222
46214,3947,884,2396,1854,1551,1356
45407,3841,942,2229,1863,1612,1429
44132,3498,957,1880,1616,1618,1375
44543,3376,987,1858,1436,1518,1281
43184,3586,989,2226,1533,1360,1143
40597,4288,1011,2894,2173,1394,1162
37370,4983,1635,3548,2860,1435,1225
33753,5507,2147,4188,3327,1319,1180
31215,5989,3049,4726,4190,1263,1141
29590,6048,3434,4688,4475,1360,1041
28520,5863,2947,4539,4040,1324,1093
28027,6024,3183,4782,4266,1242,1083
28238,5983,3539,4847,4505,1136,966
30039,5653,3439,4633,4247,1020,808
33654,5247,3051,4304,3739,943,688
35134,5173,3209,4122,3918,1051,709
35035,4605,2519,3626,3184,979,665
36521,4385,2122,3351,2833,1034,711
38576,4102,1425,3092,2069,1010,644
40502,4558,1849,3369,2748,1189,899
42187,4152,1663,2997,2686,1155,1023
43762,3265,944,2190,1800,1075,856
45010,2832,899,1809,1317,1023,868
46017,2636,913,1685,1110,951,846
46668,2634,945,1729,1002,905,717
45930,2966,966,1982,1231,984,749
44300,3357,971,2323,1733,1034,848
44590,3667,1046,2746,1721,921,675
43327,4802,1776,3773,2494,1029,718
40983,6500,3433,5247,4506,1253,1073
37478,7031,4266,5729,5372,1302,1106
33723,7007,4353,5755,5426,1252,1073
31143,7272,5072,5998,6147,1274,1075
29523,6958,4701,5806,5641,1152,940
28454,6547,4207,5490,5020,1057,813
27731,6572,4546,5498,5370,1074,824
27930,6522,4409,5540,5209,982,800
29613,6351,4276,5414,5004,937,728
33240,6211,4042,5300,4753,911,711
34791,6148,3919,5239,4605,909,686
34583,6247,4273,5419,4999,828,726
35919,5963,4106,5198,4695,765,589
37994,5804,3596,4960,4159,844,563
39769,6081,3654,5134,4307,947,653
41533,6357,3913,5269,4703,1088,790
43465,6294,3711,5230,4577,1064,866
45468,6359,3749,5275,4632,1084,883
46729,6490,3874,5333,4809,1157,935
47204,6629,3868,5424,4845,1205,977
46359,6859,4068,5564,5145,1295,1077
44719,6995,4204,5697,5310,1298,1106
44778,7141,4257,5860,5303,1281,1046
43563,7740,4982,6424,6154,1316,1172
41168,7899,5239,6521,6396,1378,1157
37839,7986,5239,6494,6434,1492,1195
34279,8253,5652,6685,6997,1568,1345
31632,7905,5232,6447,6494,1458,1262
30199,7836,5299,6450,6523,1386,1224
29156,7551,5092,6190,6218,1361,1126
28632,7076,4427,5842,5481,1234,1054
28943,6744,4170,5522,5092,1222,922
30941,6779,4415,5500,5547,1279,1132
34554,5833,3458,4811,4419,1022,961
36143,5149,2990,4208,3706,941,716
35727,4812,3299,3793,4100,1019,801
37024,4041,3453,3081,4587,960,1134
39165,3293,1676,2619,2118,674,442
41111,4113,1874,3386,2212,727,338
42447,5704,3048,4452,3793,1252,745
43994,6298,3360,4782,4384,1516,1024
44805,6362,3006,4790,4245,1572,1239
44645,6522,3064,4871,4379,1651,1315
44346,6524,2919,4849,4321,1675,1402
43115,6201,2519,4583,3848,1618,1329
42104,6096,2471,4524,3775,1572,1304
42248,6102,2700,4583,4093,1519,1393
41030,5797,2422,4539,3513,1258,1091
38645,6404,3350,5137,4489,1267,1139
35359,6484,3638,5200,4708,1284,1070
32022,6409,3622,5239,4676,1170,1054
29477,6276,3674,5160,4583,1116,909
27840,6178,3633,5025,4506,1153,873
26813,6035,3563,4948,4414,1087,851
26379,5876,3438,4908,4280,968,842
26499,5753,3339,4865,4121,888,782
27985,5774,3362,4876,4128,898,766
31267,5808,3254,4748,4055,1060,801
32780,5967,3406,4813,4584,1154,1178
32193,5532,2965,4464,4102,1068,1137
32638,5337,2341,4290,3197,1047,856
33170,6203,3009,5029,4148,1174,1139
33415,6477,3315,5115,4557,1362,1242
33243,6292,2946,4779,4264,1513,1318
32907,6170,2787,4614,4208,1556,1421
32572,5924,2586,4391,4002,1533,1416
32144,5603,2200,3987,3476,1616,1276
31775,5691,1925,3941,3365,1750,1440
31759,5696,1577,3936,2981,1760,1404
32291,6118,2078,4157,3833,1961,1755
32813,5517,1989,3732,3900,1785,1911
32302,4327,1169,3059,2381,1268,1212
31459,4325,1369,3025,2438,1300,1069
30157,4419,1249,3010,2323,1409,1074
28344,4720,1386,3193,2831,1527,1445
26881,4308,1248,2780,2615,1528,1367
25913,3730,986,2384,2014,1346,1261
25448,3347,969,2023,1757,1324,1162
25255,3037,944,1787,1509,1250,1234
25509,2533,924,1422,945,1111,932
26384,2428,886,1214,877,1214,972
27844,2235,863,1039,676,1196,1053
29496,1956,794,856,488,1100,912
30715,1797,786,619,419,1178,971
31578,1379,854,257,140,1122,994
31687,929,545,172,14,757,559
31209,854,576,126,5,728,581
30395,674,482,104,1,570,483
29592,594,534,57,1,537,535
28916,401,237,23,1,378,237
28588,383,224,33,1,350,225
28458,381,205,44,1,337,204
28683,373,207,49,1,324,206
29266,366,188,124,1,242,187
30873,426,67,303,1,123,66
30768,766,186,623,108,143,78
30155,1052,404,856,288,196,116
28996,1291,749,1052,527,239,222
27374,1422,865,1134,766,288,330
26106,1411,832,1102,692,309,355
25397,1438,820,1066,750,372,400
25037,1445,826,986,710,459,406
24977,1484,852,1014,673,470,461
25164,1351,728,886,611,465,404
25791,1223,627,771,568,452,351
26894,1149,577,761,466,388,345
28241,1155,560,744,445,411,337
29258,1135,521,828,393,307,328
29853,1130,569,735,482,395,298
29659,922,465,573,289,349,310
29220,774,358,531,239,243,276
28992,729,382,457,331,272,295
28712,522,317,293,144,229,235
28373,456,254,264,33,192,221
28268,470,313,266,68,204,245
28316,467,255,290,44,177,211
28551,510,200,361,54,149,146
29283,683,220,567,122,116,98
31615,887,232,833,201,54,31
31629,1512,717,1424,678,88,39
30687,2179,1086,1986,1182,193,96
28826,2939,1866,2668,2074,271,208
26773,3173,1812,2860,2026,313,214
25462,3702,2316,3308,2621,394,305
24681,4025,2397,3570,2776,455,379
24621,4402,2578,3812,3007,590,429
24947,4796,2839,4023,3442,773,603
25926,4758,2479,3945,3205,813,726
28541,4664,2241,3827,2894,837,653
32807,4554,2071,3683,2770,871,699
34839,4544,2140,3604,2906,940,766
34364,4400,2142,3677,2836,723,694
33832,4067,2793,3554,3351,513,558
33484,2910,1594,2506,1818,404,224
32899,2574,1199,2219,1413,355,214
32396,2468,1316,2132,1563,336,247
32259,2002,1124,1697,1349,305,225
32079,1403,720,1182,573,221,147
32008,1320,593,1087,484,233,109
32104,1394,632,1105,503,289,129
31908,1555,845,1209,638,346,207
32321,1657,886,1291,797,366,236
34027,1826,897,1482,734,344,163
33569,2633,1151,2181,1389,452,238
32118,3590,1998,2958,2360,632,362
29641,4201,2378,3559,2868,642,490
27233,4595,2800,3911,3249,684,449
25753,4862,3187,4140,3745,722,558
25010,4570,2959,3979,3463,591,504
24781,4303,2879,3732,3238,571,359
24936,4076,2345,3483,2677,593,332
25728,4335,2791,3568,3273,767,482
28125,3906,2578,3251,3249,655,671
32292,2819,1572,2329,1922,490,350
34122,2406,1178,1945,1481,461,303
33260,2140,906,1708,1207,432,301
32811,1790,841,1422,1122,368,314
32614,1157,538,821,418,336,120
32491,890,404,532,280,358,124
32414,676,422,264,123,412,299
32655,229,28,44,1,185,27
32886,268,72,28,2,240,70
33236,374,172,31,1,343,171
33577,437,188,23,2,414,186
33381,566,305,20,1,546,306
33333,617,367,53,1,564,368
34732,775,406,180,6,595,400
34236,991,458,396,48,595,410
32623,1220,673,603,202,617,483
30091,1394,686,803,396,591,435
27288,1516,657,1033,534,483,345
25452,1803,723,1286,772,517,284
24418,2114,905,1568,977,546,312
23915,2426,980,1880,1355,546,375
23743,2460,1231,1964,1602,496,371
24319,2277,1163,1760,1455,517,292
26383,2042,956,1577,1036,465,239
30218,2068,974,1633,1288,435,314
31984,1636,872,1301,713,335,159
31480,1550,910,1238,832,312,210
32028,1041,671,747,578,294,93
32899,514,158,176,125,338,33
33740,311,108,65,4,246,104
34470,201,16,31,1,170,15
35601,229,30,42,1,187,29
36656,322,110,53,1,269,109
37630,463,225,59,1,404,224
38444,551,293,59,1,492,294
38161,663,358,75,2,588,360
36853,759,435,163,14,596,449
36211,949,494,458,70,491,424
35233,1283,657,785,353,498,304
34214,1657,911,1066,724,591,364
31800,1901,941,1361,898,540,397
28746,2160,959,1692,1049,468,321
26612,2690,1229,2231,1571,459,342
25380,2895,1414,2473,1628,422,214
24684,3388,1930,2953,2186,435,256
24377,3717,2474,3348,2796,369,322
24747,3729,2706,3356,2954,373,248
26592,3692,2614,3303,2937,389,323
30185,3533,2414,3152,2772,381,358
32011,3359,2425,2966,2852,393,427
31644,2804,1835,2415,2136,389,301
32459,2412,1496,2064,1752,348,256
33748,2006,1204,1589,1364,417,160
35053,1487,698,1142,539,345,159
36374,1352,518,987,416,365,102
37969,1328,523,898,352,430,171
39272,1385,607,966,292,419,315
40392,1375,504,932,253,443,251
41089,1706,945,1087,506,619,439
40579,1745,955,1079,516,666,515
39511,1787,971,1120,626,667,532
39799,1836,906,1388,543,448,363
38600,2825,1109,2251,1587,574,478
36407,3801,2039,3077,2690,724,651
33538,4499,2572,3730,3264,769,692
30301,4901,2819,4160,3458,741,639
27966,5381,3058,4516,3627,865,569
26365,6140,3728,5158,4507,982,779
25169,6305,4124,5354,4922,951,798
24807,6048,4135,5176,4807,872,672
25262,5831,3806,4989,4426,842,620
27082,5915,3825,5075,4485,840,660
30779,5969,3930,5087,4615,882,685
32500,5876,3811,5111,4541,765,730
32134,5491,3763,4742,4313,749,550
33356,4826,3459,4159,4034,667,575
35022,3786,2119,3074,2481,712,362
36544,3627,1506,2868,1935,759,429
37879,4035,1814,3106,2472,929,658
39496,3807,1619,2786,2406,1021,787
40722,3256,987,2141,1731,1115,744
41664,2987,954,1746,1311,1241,957
41920,2815,954,1505,1110,1310,1091
40917,2661,949,1345,1004,1316,1061
39233,2705,956,1502,1040,1203,1055
38836,2958,979,2103,1060,855,713
37420,4287,1463,3333,2169,954,706
35820,5847,2762,4783,3725,1064,963
33724,6667,3977,5451,4990,1216,1013
31196,6625,3835,5454,4870,1171,1035
28906,6566,3855,5522,4898,1044,1043
27324,6294,3926,5311,4807,983,881
26187,5906,3593,4961,4346,945,753
25521,5655,3460,4696,4259,959,799
25233,4957,2918,4052,3673,905,755
25581,3839,1876,3129,2447,710,571
26604,3364,2168,2742,2788,622,620
27794,2210,1171,1807,1460,403,289
28905,1847,882,1440,901,407,175
30976,2097,971,1671,1385,426,414
33159,1694,863,1093,780,601,191
34965,1708,834,1060,663,648,453
36390,1474,865,849,491,625,397
37448,1320,822,420,409,900,504
37893,1008,626,144,19,864,645
38027,1038,649,143,19,895,668
38003,1265,738,287,24,978,762
37176,1486,708,545,70,941,682
36316,1933,903,961,312,972,770
36449,2349,967,1526,652,823,789
35250,2710,976,1603,1286,1107,725
33653,2493,942,1522,831,971,757
31646,2735,978,1756,1313,979,999
29391,2315,969,1556,1113,759,705
26953,1676,867,1203,618,473,249
25419,1676,959,1245,770,431,310
24468,2874,1723,1859,1266,1015,677
23834,1163,527,794,276,369,251
23499,1240,831,833,539,407,292
23474,965,457,662,334,303,123
23838,837,374,586,241,251,133
24617,654,184,364,112,290,72
25553,746,241,479,87,267,154
27619,664,202,451,97,213,105
29389,454,438,97,209,357,251
30709,119,2,2,1,117,1
32133,183,95,4,1,179,94
33512,187,152,15,1,172,151
34710,187,70,11,1,176,69
35551,250,101,13,1,237,100
35914,285,183,35,5,250,188
35730,301,180,48,15,253,165
35694,285,180,88,28,197,152
36602,294,29,169,13,125,16
35646,748,159,575,74,173,85
34022,1435,674,1227,534,208,140
32100,1847,859,1675,792,172,103
29505,2529,1276,2367,1385,162,109
26991,3089,1741,2855,1838,234,97
25210,3572,2133,3191,2297,381,164
24183,4040,2943,3563,3378,477,435
23703,3279,2059,2921,2386,358,327
23652,2980,1994,2665,2250,315,256
24283,2781,2515,2563,2842,218,327
26417,2088,1664,1958,1812,130,148
29959,1964,1159,1786,1256,178,97
30932,2360,1521,2100,1675,260,154
31758,2472,1351,2165,1557,307,206
33171,2824,1796,2482,2106,342,310
35181,2766,1286,2450,1508,316,222
36707,3513,1999,3068,2302,445,303
38150,3886,2523,3336,2986,550,463
39276,3401,2139,2846,2607,555,468
39826,2699,1447,2232,1823,467,376
39770,2130,909,1679,1219,451,352
39283,1641,867,1154,780,487,323
38785,1212,710,698,434,514,276
39580,964,407,545,188,419,219
38444,1024,462,593,220,431,242
36742,1062,535,594,257,468,278
34342,1087,670,540,348,547,372
30924,931,424,452,151,479,273
27921,955,517,464,133,491,384
25936,975,460,518,126,457,334
24865,1186,490,613,172,573,318
24133,1504,828,1023,375,481,695
23983,1365,706,948,476,417,230
24514,1358,631,940,444,418,187
26547,1609,822,1068,582,541,340
30227,1755,850,1076,615,679,411
30909,1862,846,1122,689,740,642
31477,1556,805,986,516,570,474
32056,1334,755,767,462,567,436
32722,1024,474,613,141,411,333
33223,1038,435,626,105,412,330
33732,976,452,592,118,384,334
34510,765,347,392,53,373,294
35079,585,331,213,6,372,325
35214,447,310,166,1,281,309
35203,364,201,131,1,233,200
35107,350,158,211,28,139,130
36126,449,155,365,97,84,58
35276,815,433,659,353,156,80
33935,1110,655,908,533,202,122
31960,1405,772,1173,761,232,169
29076,1604,899,1371,1050,233,151
26681,1703,1007,1494,1137,209,130
24999,1656,906,1484,993,172,87
24114,1652,841,1504,912,148,71
23626,1691,929,1518,1025,173,96
23608,1579,809,1378,865,201,103
24245,1521,737,1269,726,252,119
26486,1693,747,1386,869,307,196
30011,1667,732,1333,798,334,186
30731,1681,737,1361,726,320,187
31215,1795,867,1497,1155,298,288
31948,1222,678,1043,737,179,140
32675,731,130,611,121,120,9
33378,1046,327,927,261,119,66
34183,1364,467,1222,422,142,45
35142,2041,971,1762,1064,279,93
35915,2295,1039,1884,1229,411,190
36384,2418,945,1843,1221,575,276
36320,2696,963,1949,1500,747,562
35967,2609,941,1872,1370,737,521
36773,2976,941,2336,1278,640,431
35724,4782,2188,3886,2813,896,625
34511,6140,3303,5010,4141,1130,838
32562,7008,4284,5711,5345,1297,1061
29562,7049,4322,5843,5391,1206,1069
26971,6997,4357,5839,5319,1158,962
25256,7317,4988,5997,5964,1320,976
24448,7459,5080,6103,6169,1356,1089
24169,7244,4706,5876,5738,1368,1032
23869,7311,4669,5925,5779,1386,1110
24666,7271,4653,5892,5764,1379,1111
26764,7114,4497,5743,5563,1371,1066
30261,7051,4484,5682,5556,1369,1072
30801,6778,4171,5494,5175,1284,1004
31510,6456,4322,5359,5378,1097,1056
32429,5546,3482,4419,4248,1127,766
33547,5194,2504,3974,3286,1220,782
34565,5637,2400,4262,3479,1375,1079
35542,6028,2481,4494,3723,1534,1242
36608,6430,2611,4760,4120,1670,1509
37279,6452,2551,4695,4093,1757,1542
37486,6545,2489,4768,4137,1777,1648
37187,6730,2562,4899,4399,1831,1837
37162,6706,2764,4864,4622,1842,1858
38142,6669,2617,5042,4255,1627,1638
37286,7453,3646,5891,5321,1562,1675
36111,7814,4208,6190,5719,1624,1511
34221,8288,4663,6499,6337,1789,1674
31260,8560,5038,6644,6847,1916,1809
28530,8651,5210,6702,7121,1949,1911
26601,8534,5173,6644,7108,1890,1935
25542,8452,5179,6578,7028,1874,1849
24963,8374,5087,6525,6907,1849,1820
24745,8205,4898,6414,6633,1791,1735
25358,7937,4541,6129,6162,1808,1621
27190,7712,4116,5925,5765,1787,1649
30229,7232,3340,5523,4889,1709,1549
31314,7301,3532,5576,5176,1725,1644
32330,6940,3293,5122,4913,1818,1620
33886,6410,2431,4603,3918,1807,1487
35426,6494,2177,4576,3876,1918,1699
36611,6307,1942,4366,3736,1941,1794
37677,6003,1850,4007,3745,1996,1895
38757,5367,1310,3482,3088,1885,1778
39394,5068,1042,3329,2626,1739,1584
39477,5484,1492,3657,3146,1827,1654
38804,5773,1720,4008,3373,1765,1653
38008,6201,2336,4464,4034,1737,1698
38261,6652,2647,5172,4240,1480,1593
36861,7568,4041,6027,5547,1541,1506
35494,8297,4964,6548,6512,1749,1548
34025,8599,5028,6731,6703,1868,1675
31784,8806,5254,6831,7044,1975,1790
29465,8813,5214,6840,7072,1973,1858
27405,8803,5837,6692,7814,2111,1977
26063,8725,5850,6609,7849,2116,1999
25167,8678,5877,6595,7847,2083,1970
24668,8588,5778,6516,7712,2072,1934
24638,8590,5686,6519,7633,2071,1947
25184,8488,5520,6511,7421,1977,1901
26134,8394,5434,6440,7218,1954,1784
27264,8271,5103,6526,6884,1745,1781
29494,8149,5053,6434,6607,1715,1554
31610,8281,4744,6233,6375,2048,1631
33197,8816,4511,6593,6568,2223,2057
34413,8943,4509,6633,6773,2310,2264
35184,9075,4684,6738,6985,2337,2301
35617,9098,4662,6754,6982,2344,2320
35875,9253,4797,6881,7189,2372,2392
35744,9268,4793,6924,7168,2344,2375
35284,9144,4628,6845,6951,2299,2323
35609,9074,4594,6799,6865,2275,2271
36503,9142,4709,6908,6928,2234,2219
35804,9220,4873,6967,7078,2253,2205
34804,9478,5518,7113,7910,2365,2392
33578,9372,5596,7017,7951,2355,2355
31939,9079,5295,6729,7524,2350,2229
30025,8490,4218,6322,6381,2168,2163
28273,7709,3225,5690,5235,2019,2010
27026,7273,3188,5061,5338,2212,2150
26225,6376,2381,4179,4714,2197,2333
25839,5297,1277,3426,3144,1871,1867
25680,5068,1074,3408,2664,1660,1590
25936,5384,1445,3937,3019,1447,1574
26554,5546,2175,4003,3628,1543,1453
27321,5111,2015,3408,3638,1703,1623
29549,4187,1029,2438,2415,1749,1593
31718,3814,1028,2265,1375,1549,1288
33177,4661,1028,2966,2191,1695,1699
33932,4850,1021,3255,2485,1595,1508
34272,5029,1233,3559,2490,1470,1257
34324,5648,1708,4134,2986,1514,1278
34254,6330,2325,4701,3753,1629,1428
34208,6560,2516,4968,4044,1592,1528
34144,6291,2404,4744,3733,1547,1329
34885,6265,3067,4549,4863,1716,1796
36077,4619,1623,3336,3113,1283,1490
35473,3576,1012,2772,1737,804,834
34170,3875,1610,3053,2349,822,739
32538,3868,1790,3116,2540,752,750
29876,3636,2213,2995,2982,641,769
27216,2754,1120,2334,1480,420,360
25422,3028,1625,2397,2141,631,516
24465,2694,1084,1933,1957,761,873
24116,1966,897,1265,1067,701,904
24229,1666,796,754,403,912,613
25089,2147,845,854,421,1293,1266
27593,2275,1120,736,413,1539,1533
31517,2048,1143,616,234,1432,1377
32741,2044,1285,578,186,1466,1471
32983,1979,1448,352,182,1627,1630
33226,1691,1461,186,43,1505,1504
33327,1381,1171,119,1,1262,1172
33095,1246,1076,73,1,1173,1077
32727,1134,904,67,1,1067,905
32505,1157,1053,75,1,1082,1054
32227,1027,1037,91,1,936,1038
31969,797,648,80,1,717,649
32044,779,627,98,1,681,628
33507,800,571,226,1,574,572
35641,954,430,494,18,460,412
35539,1393,649,785,253,608,396
35002,2042,961,1217,655,825,615
33697,2493,976,1614,1029,879,706
31437,2854,979,1853,1363,1001,705
29338,3205,982,2118,1528,1087,817
28081,3444,982,2371,1587,1073,867
27525,3709,1154,2694,2062,1015,908
27387,3502,1327,2631,2028,871,701
27638,3426,1271,2626,1904,800,633
28695,3554,1402,2669,2048,885,646
31419,3650,1591,2769,2390,881,799
35663,3412,1375,2677,2000,735,625
36277,3512,1380,2800,1906,712,526
35728,3802,1741,2972,2347,830,606
34900,3627,1628,2840,2237,787,609
34402,3324,1046,2642,1492,682,446
33840,4106,1541,3232,2266,874,725
32908,3941,1532,3019,2223,922,691
32542,3679,1472,2777,2361,902,889
32155,2770,984,2040,1453,730,704
32071,2326,1010,1773,805,553,505
32735,2665,1016,1817,1212,848,508
34665,2841,1018,1971,1499,870,1033
36478,2305,1018,1619,863,686,460
36310,2854,1017,2017,1387,837,613
35601,3260,1018,2515,1765,745,822
33890,3324,1280,2579,1831,745,551
31228,3942,1880,3175,2734,767,854
28909,3737,1832,3026,2491,711,659
27440,3627,2088,3021,2748,606,660
26707,3133,1643,2454,2103,679,460
26480,2952,1178,2197,1822,755,644
26682,2512,1004,1778,1213,734,547
27694,2341,993,1644,1089,697,599
30328,2149,990,1453,931,696,596
34442,1907,981,1372,644,535,504
35064,1734,916,1283,603,451,422
34506,1574,895,1083,701,491,465
34234,1095,720,602,298,493,546
33607,697,437,270,66,427,433
32936,580,421,103,24,477,445
32367,509,420,53,4,456,424
32106,505,389,82,1,423,390
31747,575,407,126,1,449,408
31449,653,468,222,13,431,481
31633,718,359,387,29,331,330
33018,885,271,640,56,245,215
35007,1320,432,1134,316,186,116
34921,2213,1002,2001,1158,212,156
34527,2919,1739,2708,1905,211,166
33338,3598,2249,3290,2450,308,201
31131,4314,2826,3790,3124,524,298
29113,4778,2854,4154,3328,624,474
27875,5068,3398,4445,3952,623,554
27343,4889,3860,4394,4440,495,580
27307,3798,2455,3403,2733,395,278
27638,4021,2913,3549,3259,472,346
28670,3790,2280,3349,2630,441,350
31317,3912,2265,3392,2603,520,338
35358,4124,2736,3559,3263,565,527
35858,3374,1953,2856,2334,518,381
34923,2834,1577,2331,1945,503,368
34275,2111,989,1667,932,444,232
33740,2077,950,1591,857,486,302
33031,2066,910,1443,1221,623,483
32434,1290,735,822,366,468,369
32133,838,242,419,44,419,198
31779,751,274,274,27,477,247
31670,722,448,191,15,531,433
31917,569,398,117,22,452,379
33366,642,291,338,46,304,245
34797,869,307,660,166,209,141
34685,1428,605,1135,455,293,150
34238,2058,996,1632,1031,426,288
32893,2394,1009,1903,1398,491,389
30499,2599,1173,1966,1612,633,439
28282,2624,1095,1923,1615,701,520
26919,2335,932,1701,1217,634,467
26287,2200,970,1583,1181,617,505
26139,1719,933,1219,612,500,324
26363,1673,915,1193,562,480,434
27318,1562,862,979,574,583,582
29829,1225,687,691,254,534,681
33734,933,490,451,183,482,560
34579,738,436,307,68,431,404
34077,741,505,199,46,542,551
33662,750,761,61,9,689,770
33270,719,631,57,5,662,636
32706,843,741,86,5,757,746
32111,977,829,229,6,748,835
31938,1068,748,344,35,724,783
31687,1106,616,407,68,699,684
31347,1155,685,539,106,616,745
31248,1132,704,621,173,511,531
32201,1213,568,812,225,401,343
33486,1536,770,1272,477,264,293
33028,2099,1011,1786,1059,313,256
32588,2645,1189,2264,1532,381,343
31696,3102,1506,2690,1927,412,421
30291,3417,1669,3022,2006,395,337
28797,4068,2341,3558,2727,510,386
27654,4250,2421,3678,2835,572,414
27122,4453,2474,3793,2901,660,427
26969,4727,2691,4041,3260,686,569
27206,4599,2578,3905,3093,694,515
27780,4591,2704,3881,3294,710,590
29057,4210,2479,3572,2974,638,495
30963,3876,2112,3209,2578,667,466
32102,3716,1969,3128,2457,588,488
32761,3473,2344,3048,2777,425,433
32491,2614,1664,2293,1852,321,188
31785,2221,1027,1930,1177,291,150
30978,2383,1210,2053,1402,330,192
30173,2378,1234,2021,1474,357,240
29537,2272,975,1911,1051,361,202
29079,2820,1356,2349,1666,471,310
28796,3037,1481,2526,1822,511,341
28809,3257,1877,2756,2292,501,415
30036,3214,1934,2733,2280,481,346
31588,3399,1790,2914,2079,485,289
31364,4330,2385,3695,2815,635,430
31083,5320,3053,4511,3682,809,629
30348,6098,3926,5115,4736,983,810
29241,6516,4644,5441,5553,1075,909
27949,6439,4675,5411,5525,1028,850
26860,6365,4693,5418,5516,947,823
26245,6241,4507,5261,5298,980,791
25972,6284,4447,5293,5273,991,826
25987,6227,4319,5239,5150,988,831
26321,6094,4066,5088,4872,1006,806
27277,6203,4152,5163,4988,1040,836
28144,5975,3802,4992,4638,983,836
28886,5578,3368,4673,4119,905,751
29832,5171,3033,4384,3655,787,622
29914,4940,2693,4127,3216,813,523
29701,5141,2673,4298,3263,843,590
29399,5610,3229,4586,3943,1024,714
29270,5378,3020,4339,3887,1039,867
29063,4519,2068,3615,2786,904,718
28817,4301,2011,3395,2816,906,805
28592,3802,1541,2962,2261,840,720
28991,3582,1767,2759,2580,823,813
30559,2816,1130,2220,1811,596,681
32163,2487,1009,2085,1058,402,331
31920,3402,1346,2853,1721,549,375
31168,4855,2682,3963,3351,892,669
30041,5289,2825,4261,3628,1028,803
28291,5485,2892,4538,3694,947,802
26315,5803,3507,4767,4289,1036,782
24794,5656,3649,4592,4457,1064,808
24078,5043,3127,4096,3946,947,819
23797,4306,2447,3549,3058,757,611
23784,3921,2178,3248,2628,673,450
24491,3835,2264,3233,2727,602,463
26575,3459,1972,2956,2315,503,343
29601,3356,1943,2858,2281,498,338
30679,3062,1711,2613,2009,449,298
31126,2661,1669,2303,1955,358,286
31624,1932,1101,1606,1306,326,205
32060,1280,680,1011,578,269,102
32241,959,399,730,315,229,84
32339,710,158,545,109,165,49
32528,705,153,529,85,176,68
32590,679,154,493,67,186,87
32485,809,235,564,111,245,124
32354,952,278,657,133,295,145
33369,1096,515,735,314,361,201
34677,862,266,634,148,228,118
34080,939,324,732,254,207,70
33089,1128,573,904,483,224,90
31640,1241,702,1018,587,223,115
29363,1357,826,1134,718,223,115
26948,1418,828,1228,719,190,109
25246,1514,849,1313,768,201,81
24301,1833,928,1576,1162,257,234
23826,1694,860,1505,1020,189,212
23777,1545,831,1364,928,181,149
24392,1397,813,1189,725,208,170
26282,1268,790,1020,704,248,172
29253,1147,763,981,645,166,251
30418,917,633,818,557,99,76
30937,658,337,599,323,59,14
31567,461,178,418,175,43,3
32389,317,44,270,43,47,1
33071,234,9,233,8,1,1
33644,158,13,154,12,4,1
34494,162,2,77,1,85,1
34959,176,53,32,1,144,52
35206,190,29,7,1,183,28
34932,289,144,10,1,279,143
35196,392,209,58,1,334,208
35924,496,234,141,1,355,233
34908,670,318,222,49,448,269
33820,799,303,289,68,510,235
32219,986,396,455,110,531,286
29977,1233,669,696,328,537,341
27517,1460,818,951,526,509,292
25599,1602,844,1198,618,404,226
24462,1773,964,1428,796,345,173
23854,2149,1023,1785,1201,364,178
23729,2416,1375,2127,1642,289,267
24300,2184,1355,1979,1529,205,174
25775,1839,1052,1673,1147,166,95
28271,1780,912,1643,998,137,86
29413,1770,837,1622,789,148,48
30662,2234,1196,2060,1307,174,111
31831,2271,1427,2109,1527,162,100
32831,1971,884,1788,906,183,40
33713,2436,1021,2163,1084,273,63
34256,3361,1738,2948,1965,413,227
34842,3631,1879,3057,2173,574,294
35063,3902,1824,3181,2255,721,431
34878,4259,2028,3485,2652,774,624
34348,4188,2318,3506,3025,682,707
34638,3606,1975,3121,2478,485,503
35268,3787,2010,3273,2377,514,367
34299,4785,2711,4075,3259,710,548
33282,5623,3226,4738,3959,885,733
31952,6262,3754,5257,4601,1005,847
29925,6720,4346,5659,5321,1061,975
27756,6616,4062,5537,4925,1079,863
26110,6812,4444,5692,5405,1120,961
24826,6503,4204,5346,5133,1157,929
24068,6049,3503,4934,4348,1115,845
23746,6076,3780,5051,4702,1025,922
23734,5792,3805,4855,4599,937,794
24365,5444,3292,4708,3953,736,661
25207,5586,3965,4904,4567,682,602
26000,5209,3442,4587,3906,622,464
27915,5172,3399,4567,3864,605,465
29841,5069,3056,4368,3522,701,466
31307,5026,2724,4055,3239,971,515
32024,5094,2445,3924,3258,1170,813
31861,4610,1772,3426,2704,1184,932
31404,4179,1452,3040,2508,1139,1056
30937,3448,935,2323,1842,1125,971
30161,3039,949,1965,1352,1074,1009
29519,2693,955,1629,1139,1064,948
29636,2536,970,1370,1292,1166,1215
30217,2051,959,1256,602,795,737
29583,2506,990,1667,916,839,586
28997,3315,1002,2425,1387,890,680
28299,4387,1659,3369,2475,1018,816
27225,4968,2486,4019,3343,949,857
25799,5116,3363,4137,4169,979,806
24507,4966,2775,4123,3511,843,736
23735,5720,3508,4749,4223,971,715
23310,6422,3974,5244,4811,1178,837
23252,6912,4529,5689,5524,1223,995
23455,7188,5156,6000,6172,1188,1016
24241,7372,5627,6191,6586,1181,959
25324,7328,5638,6166,6572,1162,934
25863,7220,5372,6068,6265,1152,893
27062,7172,5254,6101,6131,1071,877
28444,6959,4941,5998,5746,961,805
29537,6998,5061,6010,5827,988,766
30124,6597,4458,5709,5188,888,730
30261,6070,3941,5307,4632,763,691
30092,5245,3234,4558,3890,687,656
29843,4571,2704,3942,3319,629,615
29547,3968,2259,3333,2777,635,518
29436,3433,1885,2874,2401,559,516
30823,2750,1308,2166,1667,584,359
31954,2533,967,2025,1044,508,388
31351,3002,1080,2449,1557,553,477
30767,3039,1246,2323,1729,716,483
29943,2696,976,1900,1270,796,533
28707,2380,966,1639,1108,741,547
27146,1952,944,1303,854,649,546
25853,1523,836,935,454,588,510
25080,1271,695,632,360,639,430
24739,1121,611,434,221,687,390
24682,1019,542,359,190,660,452
25046,1022,519,375,159,647,468
25988,1147,576,447,207,700,500
27372,1404,709,723,291,681,575
28427,1752,846,1143,447,609,531
29781,2134,889,1428,689,706,456
30445,2670,944,1699,1731,971,1109
30460,1712,841,1191,525,521,512
29990,1805,909,1413,597,392,395
29326,2004,957,1645,798,359,254
28649,2349,947,1967,1207,382,275
28162,2479,1106,2126,1368,353,262
27975,2559,1319,2236,1552,323,233
28029,2595,1350,2297,1554,298,204
29561,2983,1643,2620,1868,363,225
31441,3561,1501,3111,1702,450,201
31555,5629,3218,4968,3716,661,498
31339,6827,4835,6002,5509,825,674
30766,7123,5216,6299,5977,824,761
29689,7035,5210,6198,5898,837,688
28022,7191,5522,6289,6269,902,747
26785,7232,5585,6288,6394,944,809
26101,7168,5449,6259,6287,909,838
25878,6992,5258,6185,6046,807,788
25731,6684,4923,5898,5567,786,644
25832,6604,4766,5808,5435,796,669
26475,6485,4571,5731,5234,754,663
27357,6318,4401,5612,5038,706,637
28026,6040,4118,5359,4678,681,560
28790,5752,4237,5106,4842,646,605
28970,4833,3651,4289,4206,544,555
28748,3874,2577,3412,2994,462,417
28550,3367,1950,2995,2306,372,356
28603,3041,1543,2717,1781,324,238
28661,3279,1854,2842,2101,437,247
28673,3276,1709,2808,2033,468,324
28838,3216,1629,2749,1934,467,305
29108,3181,1717,2675,2062,506,345
30872,3055,1840,2466,2274,589,434
32914,2760,991,2123,1135,637,340
32834,4142,1203,3270,1860,872,657
31941,5850,2768,4762,3743,1088,975
30616,6332,3414,5061,4417,1271,1003
28447,6484,3196,5108,4317,1376,1121
26184,6626,3178,5187,4420,1439,1242
24593,6502,3237,5058,4493,1444,1256
23709,6110,2872,4635,4084,1475,1212
23404,5797,2481,4415,3758,1382,1277
23465,5377,2214,4139,3255,1238,1041
24056,5264,2428,4090,3478,1174,1050
26009,4729,2127,3688,3002,1041,875
29515,4452,1999,3424,2864,1028,865
30600,3918,1738,2950,2525,968,787
30940,3189,1232,2401,1927,788,695
31880,2809,1421,1783,2210,1026,789
33216,2165,967,1287,728,878,432
34165,2937,962,1780,1353,1157,824
34873,3307,972,2187,1580,1120,837
35639,3775,1109,2679,1901,1096,792
35839,4589,1657,3500,2511,1089,854
35633,5523,2729,4296,3645,1227,916
35404,5962,3258,4998,4326,964,1068
36554,6303,4420,5345,5209,958,789
37762,6665,4987,5814,5863,851,876
37030,6513,4856,5632,5620,881,764
36002,6757,4805,5871,5709,886,904
34220,6709,4512,5805,5336,904,824
31444,6576,4587,5746,5352,830,765
28542,6342,4254,5564,5024,778,770
26599,5855,3819,4984,4509,871,690
25509,5204,3286,4416,4114,788,828
25001,4341,2396,3524,2989,817,593
24971,4108,1621,3130,2315,978,694
25719,4335,1471,3005,2461,1330,990
28065,4125,994,2635,2053,1490,1305
32139,3750,1007,2346,1677,1404,1365
33734,3014,975,1765,1207,1249,1091
33655,2336,911,1147,696,1189,1005
33976,1878,821,469,349,1409,1170
34057,1412,1212,202,41,1210,1253
33784,945,803,91,2,854,805
33363,691,578,29,1,662,579
32992,471,240,36,7,435,240
32467,491,242,53,17,438,247
32187,499,256,103,34,396,290
32609,481,221,130,47,351,174
34725,656,362,279,92,377,318
36816,795,313,449,121,346,192
36921,1285,508,878,273,407,235
36592,1899,843,1381,559,518,284
35259,2917,997,2274,1219,643,453
32771,3884,1617,3133,2179,751,562
30411,4374,2057,3590,2600,784,543
28910,4813,2420,3913,3004,900,584
28335,5102,2685,4107,3371,995,686
28230,5234,2927,4280,3679,954,752
28565,4898,2600,3995,3327,903,727
29713,4605,2407,3734,3093,871,686
32561,4346,2323,3521,3037,825,714
36900,3873,2123,3158,2734,715,611
37647,3178,1346,2619,1697,559,351
36248,3183,1509,2832,1866,351,357
35017,2828,1828,2564,2039,264,211
34251,2278,1373,1981,1537,297,164
33400,1903,1029,1613,1218,290,189
32676,1591,907,1354,790,237,144
32276,1496,609,1268,517,228,92
31974,1907,894,1582,768,325,126
31848,2455,1032,2039,1254,416,222
32160,2811,1466,2439,1774,372,308
33592,2922,1773,2605,1980,317,207
35643,3371,1701,3009,1868,362,167
35527,5060,3191,4478,3552,582,361
35259,6070,4061,5312,4577,758,516
34019,6774,4883,5822,5604,952,721
31476,7024,5220,6024,6074,1000,854
29042,7017,5287,5955,6145,1062,858
27684,6983,5247,5899,6128,1084,881
27050,6995,5360,5947,6254,1048,894
26905,6737,5060,5769,5870,968,810
27215,6449,4693,5485,5387,964,694
28349,6336,4463,5396,5185,940,722
30953,6085,4003,5144,4679,941,676
34922,6026,3851,5096,4542,930,691
35817,5885,3700,4975,4360,910,660
34634,5738,3773,4922,4440,816,667
33808,4979,3301,4357,3858,622,557
33434,4085,2526,3532,2898,553,372
32903,3546,1955,2999,2303,547,348
32620,3068,1443,2572,1790,496,347
32376,2860,1335,2354,1654,506,319
32050,2685,1186,2195,1518,490,332
31943,2609,1144,2118,1450,491,306
32177,2783,1177,2306,1497,477,320
33953,3280,1590,2808,1925,472,335
35578,4015,1909,3499,2244,516,335
35425,5459,3291,4789,3841,670,550
34872,6148,4182,5388,4828,760,646
33467,6322,4258,5523,4920,799,662
30560,6707,4974,5877,5706,830,732
27956,6569,4938,5776,5656,793,718
26044,6252,4630,5541,5256,711,626
25251,6006,4355,5370,4930,636,575
24846,5747,4187,5171,4706,576,519
24582,5442,4028,4871,4515,571,487
25112,4990,3745,4492,4233,498,488
27236,4300,3080,3821,3446,479,366
30813,3746,2188,3281,2501,465,313
31764,3799,2257,3337,2636,462,379
31761,3493,2040,3098,2355,395,315
32122,2907,1608,2536,1848,371,240
32800,2445,1248,2025,1491,420,243
33042,2073,913,1668,1111,405,198
33337,1877,864,1451,869,426,202
33725,1860,894,1362,735,498,260
33948,1922,895,1343,601,579,333
33785,2408,907,1633,879,775,538
33582,2830,972,1888,1280,942,720
34425,2908,1005,2008,1356,900,744
35547,3155,1014,2322,1232,833,527
34772,4562,1404,3541,2171,1021,767
34003,6122,2749,4921,3782,1201,1033
32842,6992,3742,5622,4824,1370,1082
30706,7351,4156,5934,5329,1417,1173
28564,7299,4201,5955,5350,1344,1149
26718,7039,3897,5737,4924,1302,1027
25516,7019,3987,5742,5053,1277,1066
24739,6764,3833,5592,4877,1172,1044
24339,6471,3774,5318,4732,1153,958
24304,5892,3184,4841,4021,1051,837
24882,5563,2999,4623,3789,940,790
26061,5300,2892,4357,3576,943,684
27034,5159,2584,4206,3269,953,685
28767,5290,2746,4308,3560,982,814
30570,4922,2355,3756,3135,1166,780
32182,4484,1667,3278,2515,1206,848
33146,4282,1237,3101,2167,1181,930
33880,4201,1142,2981,2087,1220,945
34395,4081,964,2912,1915,1169,973
34794,4241,1050,2939,2179,1302,1129
34904,4281,958,2830,2160,1451,1306
34658,4156,971,2647,2189,1509,1549
35254,3684,986,2152,1886,1532,1416
36302,3420,1012,2128,1212,1292,1154
35571,4143,1014,2860,1649,1283,1057
34769,5443,1530,4033,2775,1410,1245
33702,6491,2777,5008,4200,1483,1423
31569,6582,3269,5167,4565,1415,1296
29390,6329,3123,4978,4305,1351,1182
27391,6174,3063,4764,4196,1410,1133
25978,5907,2672,4501,3785,1406,1113
24999,5842,2808,4428,4065,1414,1257
24457,5261,2494,4014,3602,1247,1108
24227,4738,2141,3672,3070,1066,929
24435,4384,1958,3506,2756,878,798
25088,4225,1997,3323,2673,902,676
25617,3978,1623,3057,2282,921,659
27399,3978,1595,3079,2352,899,757
29457,3744,1320,2842,2039,902,719
31228,3656,1141,2659,1786,997,645
32659,3985,1292,2851,2313,1134,1021
33946,3555,976,2504,1963,1051,1001
34900,3061,959,2174,1267,887,758
35580,3361,978,2452,1411,909,810
35821,3811,997,2707,1693,1104,799
35556,4381,1142,3078,2119,1303,977
36402,4842,1616,3487,2735,1355,1119
38216,5251,1788,4035,2714,1216,926
37757,6804,3259,5506,4450,1298,1191
36483,7483,4239,6095,5401,1388,1162
34851,7776,4547,6323,5755,1453,1208
32148,7879,4744,6365,5972,1514,1228
29184,7726,4862,6332,6088,1394,1226
26887,7293,4735,6055,5821,1238,1086
25592,7390,5038,6170,6159,1220,1121
24892,7402,5151,6184,6299,1218,1148
24686,7335,4907,6122,6012,1213,1105
25286,7259,4622,6045,5648,1214,1026
27250,6703,3911,5572,4779,1131,868
30811,6578,3829,5498,4733,1080,904
32025,6278,3582,5233,4426,1045,844
32250,6043,3448,5041,4369,1002,921
33327,5403,2732,4261,3509,1142,777
34782,5074,2358,3666,3220,1408,862
35777,4570,1664,3251,2777,1319,1113
36687,3794,1201,2617,2096,1177,895
37621,3234,981,2027,1543,1207,810
38181,2953,985,1706,1050,1247,942
38329,2966,991,1702,996,1264,1166
38116,2829,980,1627,905,1202,1040
38579,2974,997,1670,1188,1304,1182
40045,3024,990,1786,1206,1238,1104
39289,3354,1010,2128,1499,1226,1166
38141,3543,1000,2461,1518,1082,943
36232,4262,1388,2991,2407,1271,1019
32944,4660,2328,3113,3733,1547,1405
29715,3821,1169,2514,2185,1307,1016
27352,3844,1001,2763,1747,1081,821
26014,4676,2051,3589,3097,1087,1046
25308,4524,2645,3562,3694,962,1049
25024,3817,1789,3016,2435,801,646
25444,4323,2062,3542,2754,781,692
27373,4962,2627,4059,3301,903,674
30995,5527,3234,4527,4075,1000,841
32060,5241,2791,4253,3522,988,731
32163,5114,3231,4247,4020,867,789
33101,4087,2109,3350,2581,737,472
34363,3830,1543,3102,1974,728,431
35076,4406,2651,3610,3326,796,675
35431,3475,1800,2884,2257,591,457
35561,3137,1601,2447,2015,690,414
35463,2803,1125,2246,1680,557,555
35438,2345,940,1836,1278,509,454
35265,2118,929,1331,896,787,494
36029,1989,934,1238,789,751,619
37290,1776,926,1345,625,431,335
36664,2069,939,1567,1079,502,236
35853,2238,977,1686,1170,552,371
34030,2247,962,1668,1290,579,440
31040,2119,952,1463,1089,656,431
28121,2027,922,1329,957,698,522
26205,1950,904,1312,885,638,681
25252,1662,897,1058,617,604,434
24782,1461,812,892,421,569,391
24671,1265,630,635,289,630,341
25491,1139,652,520,235,619,449
27735,965,538,471,138,494,460
31840,837,397,416,83,421,314
33031,868,340,480,66,388,274
32599,908,376,576,121,332,255
32588,858,485,574,247,284,238
32850,515,108,413,45,102,63
32670,649,216,570,155,79,61
32496,620,193,537,164,83,29
32705,657,195,555,163,102,32
32729,731,212,601,187,130,25
32628,897,292,755,247,142,45
32777,1130,461,1022,390,108,71
34344,1354,604,1213,545,141,59
36055,1791,746,1576,678,215,68
35633,3026,1591,2706,1779,320,188
35112,4041,2185,3637,2406,404,221
33627,5345,3352,4734,3708,611,356
30942,6110,3959,5239,4459,871,500
28160,6463,4244,5663,4948,800,704
26460,6255,4055,5469,4590,786,535
25636,6459,4334,5763,4933,696,599
25316,6348,4246,5729,4750,619,504
25253,6571,4614,5885,5116,686,502
25849,6728,4753,5947,5323,781,570
27902,6678,4480,5897,5148,781,668
31603,6378,4138,5618,4762,760,624
32567,6180,4324,5357,4994,823,670
32153,5742,3993,5013,4668,729,675
32324,4965,3707,4336,4281,629,574
32758,3740,2470,3208,2894,532,424
32689,2965,1594,2564,1956,401,362
32572,2551,1438,2169,1715,382,277
32875,2199,1225,1917,1514,282,289
33147,1760,938,1505,1095,255,157
33155,1506,849,1185,795,321,119
33186,1408,749,980,564,428,185
34407,1355,740,817,460,538,280
36129,1412,733,867,412,545,321
35732,1772,795,1202,635,570,351
35061,2438,917,1821,1045,617,401
33613,3255,1130,2502,1606,753,476
30746,4065,2012,2970,2809,1095,797
27942,3738,1433,2607,2301,1131,868
26048,3465,1179,2354,2157,1111,978
25123,2997,991,2034,1704,963,784
24621,2714,1016,1886,1416,828,735
24554,2569,1016,1772,1265,797,637
25108,2402,1005,1603,1083,799,580
27191,2198,987,1395,894,803,581
30815,2019,963,1255,778,764,604
31910,1833,929,1070,800,763,653
31941,1294,789,768,317,526,586
32550,998,624,360,178,638,599
33565,650,256,56,2,594,254
33908,814,522,39,23,775,545
34213,888,701,46,6,842,707
34616,970,784,90,7,880,791
34841,1074,790,116,14,958,804
34820,1268,1102,82,31,1186,1133
34637,1320,1214,63,14,1257,1228
35680,1306,1258,58,8,1248,1266
36779,1223,1161,73,7,1150,1168
35803,1209,1115,119,14,1090,1129
34914,1105,766,209,45,896,811
33681,1182,635,437,118,745,753
31497,1314,560,594,239,720,690
29054,1485,728,819,267,666,609
27071,1748,835,986,447,762,560
25711,1917,844,1129,542,788,624
25090,1829,798,1121,584,708,525
24725,1822,909,1290,496,532,468
24817,1939,910,1429,829,510,398
25531,1800,914,1297,887,503,386
26878,1489,821,1062,548,427,347
28016,1433,838,966,529,467,372
29562,1224,709,741,313,483,396
31208,941,563,336,133,605,430
32551,700,332,129,14,571,318
33079,792,360,177,17,615,377
33310,1020,406,376,44,644,362
33470,1534,638,798,143,736,495
33518,2369,870,1403,598,966,811
33496,2800,918,1718,893,1082,904
33388,3120,927,1771,1314,1349,1151
34635,2904,894,1338,1427,1566,1502
35949,2189,896,1162,434,1027,855
35302,2913,1000,1676,1232,1237,1210
34495,3276,1011,2290,1354,986,868
33500,4236,1270,3165,2052,1071,782
31580,5494,2236,4214,3248,1280,1012
29447,6173,2964,4817,4241,1356,1277
27641,5935,2757,4725,3889,1210,1132
26369,5919,2931,4733,3919,1186,988
25560,6114,3355,4840,4398,1274,1043
25037,5896,3234,4612,4265,1284,1031
24919,5612,3309,4483,4436,1129,1127
25127,4892,2923,3987,3779,905,856
25720,4273,2214,3445,2809,828,595
26389,4330,2428,3554,3202,776,774
27896,3906,2082,3275,2680,631,598
29658,3927,1788,3147,2314,780,526
31030,4413,1998,3406,2715,1007,717
31793,4514,2182,3299,3135,1215,953
32373,3830,1150,2631,2027,1199,877
32652,3863,1019,2502,1982,1361,972
32670,3963,1008,2528,1898,1435,1074
32723,4303,1006,2799,2039,1504,1203
32925,4766,1229,3250,2591,1516,1362
35057,5155,1853,3713,3303,1442,1450
37070,5408,2247,4186,3472,1222,1225
36968,6084,2802,4815,3866,1269,1064
36292,7174,3765,5810,5018,1364,1253
34971,7734,4464,6416,5769,1318,1305
32637,7873,4814,6633,6040,1240,1226
30010,7954,4977,6718,6181,1236,1204
28338,7948,5097,6663,6301,1285,1204
27400,7519,5011,6259,6235,1260,1224
27014,6318,4725,5147,6141,1171,1416
27263,4151,1844,3087,2854,1064,1010
28448,3561,1012,2365,2149,1196,1181
31584,3267,1002,2028,1862,1239,1275
36356,3462,1012,2005,1555,1457,1276
38625,3859,996,2261,1478,1598,1463
38319,4086,992,2283,1751,1803,1589
38278,3801,985,2111,1390,1690,1440
38191,3569,972,1700,1415,1869,1576
37564,2795,934,946,841,1849,1525
36790,1934,898,418,222,1516,1120
36066,1665,1005,328,99,1337,1104
35184,1402,856,220,65,1182,921
34755,1066,770,155,30,911,800
35616,763,578,114,16,649,594
38563,599,414,61,9,538,423
42224,579,489,212,9,367,498
42736,626,227,257,56,369,171
42729,1075,579,569,225,506,354
41706,1461,701,912,461,549,492
38920,1723,768,1213,676,510,441
36482,2119,894,1490,969,629,396
35131,2574,938,1962,1359,612,508
34696,3124,984,2504,1640,620,656
34740,3425,1457,2698,2039,727,582
35217,3641,1591,2755,2300,886,709
36587,3342,1366,2516,1984,826,618
39581,3282,1218,2460,1901,822,683
44170,3285,1334,2444,2177,841,843
45041,2712,1038,2101,1628,611,590
43065,2113,902,1685,1027,428,333
41272,1843,862,1342,1131,501,365
39895,1117,543,740,295,377,248
38227,909,511,599,234,310,277
36636,675,231,482,45,193,186
35471,506,134,386,65,120,69
34556,456,132,349,58,107,74
34174,436,136,368,67,68,69
35256,557,235,472,150,85,85
38270,561,255,412,170,149,85
41465,566,99,469,24,97,75
42039,741,247,634,165,107,82
42381,1048,670,834,487,214,183
41404,1796,1232,1347,1961,449,729
38786,1401,868,1066,545,335,324
36479,1868,914,1468,805,400,328
35210,2530,978,2131,1424,399,446
34864,2789,1244,2368,1623,421,379
35037,3099,1667,2611,2092,488,425
35650,3139,1883,2744,2254,395,371
37077,2985,1713,2702,1948,283,235
40235,3319,2102,2977,2363,342,261
44836,3471,2118,3111,2361,360,243
45385,3562,2096,3177,2293,385,197
42891,3763,2166,3379,2407,384,241
40478,3811,2793,3444,3130,367,337
38707,2983,1844,2735,2092,248,248
36803,2672,1352,2454,1474,218,122
35226,3226,1818,2964,1988,262,170
34088,3547,2301,3164,2522,383,221
33251,3383,1767,2969,2051,414,284
32856,3532,1733,3084,2023,448,290
33308,4110,2343,3501,2754,609,411
36043,4456,2842,3814,3415,642,573
39314,4609,2267,3973,2701,636,434
39829,6272,3842,5405,4537,867,695
39973,7236,4925,6232,5796,1004,871
39190,7529,5307,6496,6247,1033,940
36624,7390,5180,6348,6076,1042,896
34290,7354,5115,6371,6046,983,931
32938,7220,5081,6284,5920,936,839
32434,7063,4956,6114,5722,949,766
32438,6995,4863,6067,5613,928,750
32947,6970,4851,5970,5585,1000,734
34221,6755,4342,5764,5079,991,737
37111,6797,4334,5815,5155,982,821
41603,6728,4296,5757,5081,971,785
42295,6667,4180,5633,4931,1034,751
40156,6503,4307,5538,5090,965,783
38295,5719,3728,4849,4374,870,646
37002,4911,2573,4071,3041,840,468
35450,5067,2846,4015,3443,1052,597
34168,4677,2096,3557,2815,1120,719
33383,4490,1485,3360,2194,1130,709
32788,5352,2076,4040,3082,1312,1006
32506,5519,2297,4194,3292,1325,995
32952,5590,2364,4332,3383,1258,1019
35404,5785,2678,4613,3674,1172,996
37548,6244,3436,5331,4480,913,1044
37544,6406,4211,5485,5055,921,844
37255,6426,4047,5488,4835,938,788
36009,6808,4273,5785,5178,1023,905
33148,7094,4612,5949,5562,1145,950
30407,7399,5022,6203,6068,1196,1046
28568,7252,4778,5951,5835,1301,1057
27562,6925,4426,5539,5547,1386,1121
27076,6349,3673,5010,4714,1339,1041
26966,6221,3473,4970,4478,1251,1005
27635,6345,3548,5145,4506,1200,958
29781,6613,3698,5347,4655,1266,957
33457,6977,3956,5604,4998,1373,1042
34504,7131,3913,5786,5072,1345,1159
34111,7312,4010,5948,5255,1364,1245
34266,7836,4589,6188,5937,1648,1348
34555,8196,4829,6182,6325,2014,1496
34350,8571,4730,6396,6516,2175,1786
34022,8826,5026,6491,7017,2335,1991
33960,9045,5179,6703,7294,2342,2115
33496,9119,5567,6658,7731,2461,2164
33299,9118,5294,6648,7425,2470,2131
33696,8974,5093,6578,7193,2396,2100
35487,8744,4787,6476,6810,2268,2023
36323,8117,4319,5945,6239,2172,1920
35428,7224,3738,5093,5766,2131,2028
34669,6193,2580,4295,4378,1898,1798
33592,6360,3019,4706,4741,1654,1722
31609,6547,3328,4865,4741,1682,1413
29258,6994,3403,5206,4941,1788,1538
27343,7197,3379,5379,5091,1818,1712
26092,7152,3356,5404,5032,1748,1676
25319,6927,3716,5220,5275,1707,1559
25000,6091,3258,4567,4472,1524,1214
25032,5534,2837,4053,3865,1481,1028
25745,5298,2767,4072,3829,1226,1062
27083,4970,2629,3932,3351,1038,722
28365,5236,3161,4364,3909,872,748
29832,5068,3432,4322,4051,746,619
31123,4584,3456,3860,4027,724,571
31998,3598,2450,2995,2788,603,338
32193,3307,2185,2726,2419,581,234
32065,3216,2228,2690,2483,526,255
31842,3029,1988,2560,2175,469,187
31616,3113,2017,2615,2239,498,222
31451,3156,1991,2483,2277,673,286
31524,2822,1398,2099,1739,723,341
33399,2668,1058,1923,1485,745,427
34824,2813,926,2106,1300,707,440
34375,3609,1421,2824,2063,785,642
33825,3960,1705,3110,2382,850,677
33032,4291,2069,3367,2906,924,837
31297,4281,2023,3237,2791,1044,768
29254,4516,2251,3450,3291,1066,1040
27364,4075,2129,3212,2888,863,759
26150,4090,2253,3178,3033,912,780
25391,4068,2016,3232,2757,836,741
25056,4289,2419,3435,3124,854,705
25000,4393,2678,3583,3394,810,716
25405,4380,2680,3866,3307,514,627
26276,4564,3123,4172,3502,392,379
27253,5050,3885,4620,4258,430,373
28650,4798,3733,4383,4034,415,301
29868,4351,3818,3846,4177,505,359
30398,3200,1644,2724,1822,476,178
30548,3602,1788,3126,2020,476,232
30565,4149,2362,3574,2668,575,306
30467,4182,2423,3616,2742,566,319
30355,4105,2493,3673,2804,432,311
30303,4048,3015,3639,3318,409,303
30452,3370,1777,3070,2009,300,232
32524,3842,2807,3589,3115,253,308
34418,3517,2350,3292,2524,225,174
34602,3956,2625,3555,2849,401,224
34145,4704,3117,4263,3529,441,412
33082,5365,3756,4787,4178,578,422
30802,5904,4129,5248,4695,656,566
28259,6230,4470,5528,5140,702,670
26397,6100,3958,5338,4525,762,567
25474,6525,4360,5621,5101,904,741
25110,6561,4190,5613,5058,948,868
25295,6354,3640,5383,4556,971,916
26161,6460,4039,5422,5006,1038,967
28803,6084,3518,4948,4594,1136,1076
32699,5431,2661,4303,3666,1128,1005
34263,5026,2642,3938,3594,1088,952
33680,4418,2541,3247,3530,1171,989
33535,3404,1484,2642,2485,762,1001
33619,2748,1010,2073,1424,675,414
33540,3342,1354,2538,1902,804,548
33055,4007,1913,3177,2621,830,708
33033,4099,1779,3446,2250,653,471
32926,5170,2947,4454,3491,716,544
32819,5376,3617,4713,4246,663,629
32967,4540,3402,4044,3929,496,527
34346,3561,2918,3196,3256,365,338
36749,2895,1676,2591,1886,304,210
36713,3452,2072,3118,2322,334,250
36362,4211,3003,3847,3329,364,326
35252,4590,3467,4144,3791,446,324
32514,5025,3642,4471,4004,554,362
29934,5304,3491,4591,3958,713,467
28236,5556,3318,4633,3896,923,578
27520,5908,3297,4740,4030,1168,733
27225,6312,3494,5053,4503,1259,1009
27479,6132,3673,5014,4690,1118,1017
28433,5398,3070,4304,3759,1094,689
31122,5229,2470,4010,3227,1219,757
35474,5203,2282,3808,3223,1395,941
36596,4805,1779,3491,2848,1314,1069
35224,4285,1831,3048,2772,1237,941
34249,3251,1328,2159,2241,1092,913
33843,2022,946,984,767,1038,445
33440,1631,812,709,278,922,553
33193,1614,753,701,220,913,533
33419,1698,743,764,188,934,555
33663,1929,881,796,322,1133,793
33795,1923,841,882,218,1041,823
33842,2376,872,1110,604,1266,1211
34879,2504,896,1203,759,1301,1243
36767,2896,938,1520,1061,1376,1138
36524,4071,999,2338,2157,1733,1570
35903,4769,1079,3284,2501,1485,1422
34550,5897,2048,4446,3314,1451,1266
31946,7394,3453,5544,4960,1850,1507
29125,8040,4072,5984,5995,2056,1923
27012,7939,4295,5898,6241,2041,1946
25979,7432,3464,5597,5104,1835,1640
25473,7446,3566,5619,5260,1827,1694
25443,7259,3167,5512,4764,1747,1597
26024,7740,3802,5849,5488,1891,1686
27895,7906,3867,5812,5530,2094,1663
31552,8156,3744,6004,5616,2152,1872
32786,7824,3285,5793,5110,2031,1825
32740,7779,3533,5777,5346,2002,1813
33630,7412,3307,5588,4983,1824,1676
34667,7177,3126,5508,4617,1669,1491
35193,7378,3476,5725,5041,1653,1565
35491,7320,3444,5646,5025,1674,1581
36030,7293,3399,5655,4887,1638,1488
36276,7829,4107,6165,5831,1664,1724
36347,7628,4188,5903,5869,1725,1681
36341,7462,4656,5714,6287,1748,1631
37778,6890,3457,5397,4801,1493,1344
39574,7683,4233,5864,5607,1819,1374
39260,8766,5473,6659,7236,2107,1763
38548,8865,5510,6719,7310,2146,1800
36890,8867,5729,6836,7540,2031,1811
33731,8807,5810,6921,7581,1886,1771
30556,8541,5842,6819,7417,1722,1575
28180,8386,5747,6778,7289,1608,1542
27062,8372,5616,6809,7225,1563,1609
26394,8049,5044,6398,6522,1651,1478
26258,8115,4396,6057,6159,2058,1763
27210,8042,3286,5815,5395,2227,2109
29788,7765,3022,5493,5106,2272,2084
34195,7402,2767,5164,4787,2238,2020
36341,6950,2397,4822,4350,2128,1953
36266,6425,2153,4287,4224,2138,2071
36370,5307,1213,3205,3073,2102,1860
36541,4533,953,2699,1898,1834,1643
35964,4609,941,2658,2192,1951,1789
35138,4072,944,2414,1524,1658,1472
34597,3952,939,2296,1555,1656,1403
33999,3553,927,1932,1303,1621,1340
33778,2896,905,1383,811,1513,1282
34448,2145,769,836,362,1309,1013
36901,1768,837,435,243,1333,1080
39949,1264,860,300,122,964,982
40551,1013,525,237,124,776,578
40803,1068,638,363,146,705,550
40472,1175,647,540,241,635,406
38482,1403,856,838,505,565,351
36523,1809,953,1221,904,588,388
35085,2286,971,1730,1347,556,472
34557,2711,1027,2115,1583,596,556
34576,2811,1133,2233,1525,578,392
35070,3298,1641,2749,2160,549,519
36356,3290,2126,2825,2557,465,431
39052,2879,1738,2443,1985,436,247
43021,2882,1652,2489,1886,393,234
44019,3002,1844,2588,2092,414,248
42568,2744,1570,2344,1762,400,192
40770,2507,1626,2218,1921,289,295
38826,1795,896,1573,948,222,115
36693,1714,883,1524,835,190,115
34648,1883,909,1651,994,232,129
33422,2069,917,1864,1111,205,196
32432,2161,998,1930,1137,231,139
31863,2415,1071,2082,1225,333,154
31991,2837,1681,2401,1950,436,269
34196,2863,1591,2501,1894,362,303
36573,3162,1507,2742,1721,420,214
36716,4431,2292,3842,2679,589,387
36819,5694,3319,4941,3869,753,550
36526,6488,4118,5605,4816,883,698
35079,6998,4782,6008,5568,990,786
33567,7090,4887,6061,5714,1029,827
32068,7168,5107,6112,5947,1056,840
31389,7055,5003,5965,5814,1090,811
31070,6946,4781,5826,5577,1120,796
31292,6913,4657,5745,5504,1168,847
31869,6722,4298,5590,5153,1132,855
33163,6411,3964,5269,4837,1142,873
34915,5998,3242,4727,3975,1271,733
36234,6265,3150,4835,4018,1430,868
36668,6368,3385,5007,4395,1361,1010
35729,5764,3003,4583,3869,1181,866
34414,5300,2246,4032,2841,1268,595
32636,6174,2569,4639,3580,1535,1011
31247,6390,2442,4788,3714,1602,1272
30177,6282,2346,4671,3592,1611,1246
29441,6396,2441,4592,3752,1804,1311
29154,6389,2294,4615,3775,1774,1481
29412,6184,2719,4483,4290,1701,1571
31368,5452,2217,3897,3386,1555,1169
33230,5856,2355,4571,3672,1285,1317
33101,6362,3054,5052,4082,1310,1028
32731,7196,3917,5682,5085,1514,1168
32017,7422,3773,5733,5062,1689,1289
30310,7679,3872,5998,5377,1681,1505
28419,7412,3970,5790,5259,1622,1289
26671,7278,3816,5754,5230,1524,1414
25445,6813,3661,5300,4863,1513,1202
24824,6441,3472,5159,4659,1282,1187
24476,6069,3418,4860,4458,1209,1040
24535,5673,3121,4506,4128,1167,1007
24978,5340,2844,4092,3873,1248,1029
25828,4911,2559,3658,3569,1253,1010
26628,4272,1935,3183,2918,1089,983
27796,3717,1685,2748,2447,969,762
28860,3228,1320,2232,2113,996,793
29222,2510,993,1155,1214,1355,654
29270,2230,950,814,601,1416,908
29287,2209,943,872,534,1337,959
29135,2392,926,1299,774,1093,809
28921,2707,925,1719,1109,988,670
28910,3167,934,2106,1608,1061,746
29274,3442,1055,2256,1923,1186,868
31220,3533,950,2444,1619,1089,780
33191,4305,1367,3220,2257,1085,890
33170,4981,2236,3798,3238,1183,1002
32937,4673,1810,3488,2836,1185,1026
32400,4654,1740,3357,2714,1297,974
31089,4750,1638,3282,2855,1468,1217
29254,4265,1401,2992,2796,1273,1395
27621,3342,1385,2301,2266,1041,881
26641,2738,1295,1919,1975,819,680
26283,1920,977,1404,1023,516,426
26363,1722,913,1327,892,395,443
27011,1483,889,1198,801,285,206
28351,1322,572,1111,448,211,124
30321,1533,801,1224,617,309,184
31702,1595,705,1222,432,373,273
32830,1745,847,1301,693,444,331
33608,1450,831,1096,961,354,448
33580,501,58,363,32,138,26
32974,640,154,347,90,293,64
32289,820,297,298,141,522,156
31804,663,220,252,23,411,197
31489,800,269,380,54,420,215
31405,1107,477,495,210,612,267
31513,1484,781,542,411,942,565
33029,1628,875,685,327,943,740
34221,1859,957,1130,390,729,567
33447,2436,999,1536,1027,900,676
32769,2777,999,1966,1124,811,695
32041,3465,1006,2668,1545,797,653
31036,4377,1763,3019,2477,1358,714
29607,5132,1852,3594,3265,1538,1413
28128,4941,1834,3225,3147,1716,1313
27164,5003,2184,2849,4025,2154,1841
26571,4336,1445,2709,2968,1627,1523
26212,4214,1756,2843,3178,1371,1422
26195,3930,1615,2643,2695,1287,1080
26694,4070,1309,2807,2278,1263,969
27587,5013,1823,3612,2833,1401,1010
28649,6262,2378,4574,3692,1688,1314
30276,7434,3218,5639,4914,1795,1696
31765,7937,3872,6065,5502,1872,1630
32826,8622,4789,6794,6663,1828,1874
33263,8411,4427,6364,6116,2047,1689
33382,8653,3936,6357,5984,2296,2048
33460,8504,3661,6241,5670,2263,2009
33566,8465,3679,6224,5618,2241,1939
33777,8534,3787,6238,5757,2296,1970
34167,8394,3643,6157,5596,2237,1953
36063,8060,3492,5961,5372,2099,1880
38519,7722,3236,5727,4964,1995,1728
39179,7743,3142,5647,4866,2096,1724
39735,7911,3109,5743,5069,2168,1960
39784,7656,2923,5528,4826,2128,1903
38945,7326,3032,5071,5079,2255,2047
37678,6109,2238,3981,4362,2128,2124
36820,4480,998,2867,2509,1613,1594
36361,3633,984,2384,1737,1249,1159
36309,3242,1000,2062,1364,1180,950
36871,2988,994,1786,964,1202,766
38105,3336,993,2072,1382,1264,1229
40241,2901,993,1864,1183,1037,909
43022,2586,969,1670,925,916,669
44740,2507,943,1604,940,903,716
45411,2092,908,1270,604,822,505
45581,1973,856,993,645,980,672
45121,1445,681,626,665,819,1138
43697,423,172,101,33,322,139
42002,294,234,81,23,213,257
40506,150,33,57,22,93,11
39194,145,23,78,22,67,1
38617,224,57,212,40,12,17
39127,390,77,319,56,71,21
41741,676,174,551,166,125,8
44907,1209,478,1072,468,137,10
45195,1858,910,1638,859,220,51
45053,2848,1712,2416,1916,432,204
43852,3295,1615,2778,1945,517,330
42046,3979,2060,3311,2474,668,414
40154,4795,2650,4052,3252,743,602
38874,5083,2601,4371,3145,712,544
38379,5886,3358,5079,3951,807,593
38218,6383,3776,5546,4444,837,668
38421,6579,4139,5741,4808,838,669
39253,6384,3995,5528,4645,856,650
41053,6221,4115,5308,4828,913,713
43263,5674,3772,4739,4525,935,753
44319,4836,2971,3918,3714,918,743
44247,4038,2223,3344,2964,694,741
43846,3043,1422,2537,1860,506,438
43315,2725,1537,2134,1898,591,361
42046,2177,929,1771,1438,406,541
40558,1311,732,1110,560,201,172
39308,1059,487,888,364,171,123
38430,1085,628,829,464,256,164
38377,965,620,730,416,235,204
39134,860,419,702,259,158,160
40632,1092,610,931,420,161,190
41975,1342,820,1166,663,176,157
41320,1716,907,1597,1039,119,204
40350,2079,1565,1951,1746,128,181
38542,1950,1282,1744,1497,206,215
36136,2001,1081,1839,1324,162,243
33717,2118,1019,1915,1233,203,214
31948,2431,1370,2140,1670,291,300
30835,2469,1429,2215,1775,254,346
30364,2109,1064,1854,1133,255,69
30294,2668,1529,2231,1602,437,73
30883,3254,1552,2727,1963,527,411
32433,3617,2543,3111,3144,506,601
34585,3016,1922,2671,2415,345,493
36104,2720,1112,2288,1327,432,215
36812,3625,1660,2994,2018,631,358
37522,4406,2208,3384,2842,1022,634
38041,4273,2046,2967,3080,1306,1034
37946,3310,998,2013,2014,1297,1021
37600,2875,994,1742,1094,1133,964
37099,3130,1022,1897,1235,1233,962
36267,3484,1022,2108,1564,1376,1198
36007,3228,1016,2033,1301,1195,1147
36534,2829,987,1818,1259,1011,1002
38923,2111,923,1296,947,815,744
41304,1550,850,926,349,624,505
41517,1726,841,1016,386,710,614
41531,2123,847,1056,670,1067,978
40848,2284,823,930,628,1354,1235
39650,2199,856,702,500,1497,1356
38343,1964,924,603,397,1361,1321
37329,1744,820,531,323,1213,1143
36901,1589,692,413,263,1176,906
36803,1630,906,391,201,1239,1107
37069,1543,779,455,154,1088,933
37695,1600,646,512,217,1088,838
38795,1769,770,631,312,1138,1082
40354,1615,794,652,231,963,760
41591,1556,769,675,265,881,620
42186,1578,765,594,276,984,777
41806,1347,671,352,146,995,703
40752,1140,818,194,41,946,859
39291,910,759,103,10,807,769
37504,831,677,106,15,725,692
35882,809,585,96,26,713,611
34718,814,559,128,28,686,587
34115,857,604,240,67,617,671
34352,861,505,409,150,452,462
36747,1012,600,726,309,286,291
39605,1415,624,1221,457,194,167
40164,2237,966,1996,1132,241,184
40523,3158,2054,2893,2357,265,303
40312,3420,1893,3130,2118,290,225
39324,4369,2647,3935,2953,434,306
38119,5234,3324,4648,3762,586,438
37214,5665,3668,4974,4188,691,520
36748,5870,3557,5053,4072,817,515
36650,6432,3940,5467,4708,965,768
36892,6293,3866,5308,4613,985,747
37461,6059,3529,5106,4230,953,701
38378,6213,3706,5146,4393,1067,687
39526,6492,4090,5309,5009,1183,919
40270,5992,3215,5001,3990,991,775
40514,6116,3371,5193,3990,923,619
40382,6393,3721,5549,4380,844,659
39775,6554,3926,5679,4565,875,639
38633,6766,4058,5724,4788,1042,730
37348,7003,4029,5808,4861,1195,832
36085,7104,4063,5816,4950,1288,887
35166,7061,3984,5628,4962,1433,978
34632,6841,3735,5361,4848,1480,1113
35096,6358,3102,4962,4196,1396,1094
37354,6411,3560,5068,4736,1343,1176
39101,6156,3908,4787,5069,1369,1161
38991,5636,2692,4500,3707,1136,1015
38354,6232,3021,5023,4039,1209,1018
37404,7044,3674,5736,4884,1308,1210
35749,7438,4091,5950,5377,1488,1286
33780,7411,3849,5815,5110,1596,1261
32043,7614,3948,6048,5365,1566,1417
30914,7433,3964,5882,5254,1551,1290
30375,7265,4068,5814,5350,1451,1282
30316,7009,3818,5550,4959,1459,1141
30859,7140,4222,5571,5529,1569,1307
32159,6833,4144,5316,5425,1517,1281
33652,6170,4090,4746,5579,1424,1489
34669,5151,4083,3977,5616,1174,1533
35394,5276,4377,4393,5982,883,1605
36271,4802,2996,3732,4462,1070,1466
36731,4616,2512,2955,4127,1661,1615
36623,3805,1287,2093,2600,1712,1313
36197,3564,982,2023,2134,1541,1445
35502,3459,988,2245,2051,1214,1201
34589,3656,1175,2536,2091,1120,916
34061,3982,1470,2683,2543,1299,1073
34172,3819,1115,2656,2333,1163,1218
35606,3437,1218,2218,2363,1219,1145
36502,2881,1007,1662,1557,1219,784
35314,2842,1011,1836,1342,1006,909
33847,2759,1009,1888,1328,871,663
32382,2907,1051,2061,1883,846,832
30971,2672,1021,2015,1293,657,701
