load,windall,windallsigma,windmidatl,windmidatlsigma,windwest,windwestsigma
81308,2806,1132,440,245,2366,1067
78675,2760,1120,423,248,2337,1060
76223,2569,1163,379,238,2190,1058
75064,2295,1204,352,234,1943,1035
75248,2197,1168,333,223,1864,1000
76423,2244,1156,331,214,1913,1000
78152,2273,1195,327,221,1946,1029
79546,2326,1165,316,221,2010,1011
80703,2383,1044,319,213,2064,901
83419,2594,1045,342,214,2252,893
86214,2709,1351,354,225,2355,1189
88006,2781,1565,374,238,2407,1389
88547,2756,1489,378,234,2378,1315
88313,2813,1411,400,242,2413,1220
87943,2732,1391,389,264,2343,1184
88056,2753,1390,382,254,2371,1200
91009,2772,1344,357,246,2415,1157
97587,2847,1296,386,268,2461,1089
99688,2927,1269,391,264,2536,1042
99187,2981,1260,401,263,2580,1028
97710,3016,1270,418,274,2598,1023
94492,3056,1259,454,280,2602,1018
89660,2975,1265,459,283,2516,1033
85014,2942,1293,439,280,2503,1107
81597,2927,1229,441,265,2486,1079
79860,2857,1209,431,252,2426,1080
79393,2664,1080,407,251,2257,994
79936,2516,973,379,248,2137,938
82162,2349,945,364,246,1985,930
88026,2194,950,354,246,1840,928
97307,2161,940,339,234,1822,939
103905,2161,925,351,227,1810,954
105164,2170,979,360,212,1810,1014
104721,2154,1037,371,207,1783,1052
104392,2113,1075,376,197,1737,1080
103435,2109,1060,356,194,1753,1066
102142,2212,1005,364,149,1848,1029
101212,2285,986,364,121,1921,1017
100141,2232,1020,305,115,1927,1031
100242,2179,1088,254,117,1925,1063
103376,2077,1076,218,105,1859,1024
111768,2167,1124,213,111,1954,1057
114527,2386,1180,221,125,2165,1100
113732,2519,1213,244,155,2275,1086
111968,2735,1220,270,156,2465,1086
108069,2835,1160,299,127,2536,1042
101894,2795,1183,319,151,2476,1047
95643,2777,1144,329,211,2448,978
91289,2728,1154,349,244,2379,974
89008,2506,1139,375,256,2131,988
87885,2355,1087,407,263,1948,973
87851,2207,1044,437,255,1770,953
89810,2065,888,465,219,1600,848
95335,1953,660,519,211,1434,708
104500,1967,557,567,212,1400,631
110360,1933,489,575,197,1358,578
110163,1888,403,554,179,1334,488
108699,1865,375,515,178,1350,468
107068,1831,436,520,169,1311,490
105484,1865,522,506,177,1359,573
103726,1940,519,498,171,1442,551
102190,1993,559,454,165,1539,589
100665,2096,668,422,136,1674,666
100428,2194,739,385,104,1809,722
103240,2250,729,365,88,1885,723
111377,2298,744,368,90,1930,713
114329,2447,819,397,92,2050,778
113508,2472,818,399,108,2073,837
111910,2513,774,403,160,2110,861
107991,2575,775,425,175,2150,883
101886,2603,774,438,173,2165,888
95755,2644,812,406,148,2238,928
91138,2741,809,412,105,2329,884
88809,2651,900,444,73,2207,922
87601,2669,936,498,85,2171,954
87822,2688,864,510,91,2178,880
89767,2802,833,532,84,2270,807
94675,3009,661,540,77,2469,626
103703,3178,525,563,85,2615,493
109242,3228,623,540,115,2688,541
108828,3176,739,553,133,2623,627
107231,3154,884,558,138,2596,774
105701,3187,1067,564,169,2623,955
104235,3228,1167,583,217,2645,1041
102032,3147,1243,577,243,2570,1108
99931,3200,1170,574,270,2626,1003
98061,3161,1103,568,259,2593,992
97514,3176,1045,580,251,2596,951
99918,3090,1104,600,223,2490,1031
107189,3157,1150,651,207,2506,1091
109582,3102,1212,668,194,2434,1165
108368,3060,1246,682,176,2378,1213
106287,3039,1243,688,141,2351,1183
103419,3035,1256,689,127,2346,1194
98584,3001,1201,673,135,2328,1125
93109,2891,1063,652,140,2239,978
88586,2815,916,628,143,2187,816
86109,2736,1006,588,187,2148,840
84573,2578,952,560,210,2018,750
84341,2330,865,540,230,1790,640
84856,2194,733,524,234,1670,509
87088,2141,708,505,236,1636,480
90449,2186,655,495,237,1691,448
93790,2395,547,467,251,1928,326
96054,2406,431,422,257,1984,244
96087,2420,438,396,264,2024,270
94976,2201,561,387,280,1814,383
92917,2078,694,394,271,1684,564
90490,2156,841,392,297,1764,678
88289,2273,916,385,324,1888,778
86991,2160,990,385,338,1775,816
87292,2043,1141,395,347,1648,918
90134,2036,1240,381,353,1655,1008
97496,2197,1202,373,355,1824,1015
100151,2508,1007,345,297,2163,956
99238,2825,930,358,267,2467,902
97906,2926,991,367,244,2559,931
95110,3006,1153,379,217,2627,1043
90538,2997,1290,404,207,2593,1177
85446,2851,1333,393,213,2458,1195
81066,2717,1284,374,216,2343,1136
78346,2760,1274,396,232,2364,1093
76673,2716,1214,411,232,2305,1027
75895,2699,1209,414,237,2285,1026
76286,2511,1178,411,267,2100,1002
77653,2441,1180,393,256,2048,1036
80418,2422,1121,382,260,2040,961
83658,2521,1043,381,270,2140,864
86174,2639,979,387,293,2252,801
87306,2371,1018,349,306,2022,823
87025,2219,1019,326,299,1893,827
86373,2134,939,316,265,1818,760
85883,2189,907,335,269,1854,733
85334,2269,901,356,277,1913,718
84964,2276,881,374,274,1902,675
85524,2230,894,376,266,1854,668
88707,2184,943,376,248,1808,763
95599,2375,1007,411,225,1964,886
98435,2529,1018,438,212,2091,931
97636,2751,934,476,189,2275,859
96407,2896,911,513,166,2383,863
92783,2931,943,549,143,2382,907
88085,2911,916,554,129,2357,880
83409,2875,1090,527,140,2348,1040
79855,2847,1249,512,168,2335,1180
78065,2792,1336,501,185,2291,1259
77534,2698,1373,500,209,2198,1263
77932,2667,1381,494,234,2173,1230
80389,2637,1377,486,249,2151,1187
86511,2569,1386,465,258,2104,1180
96447,2569,1335,441,258,2128,1124
102694,2601,1277,432,261,2169,1071
102519,2654,1268,431,276,2223,1057
101036,2471,1285,428,300,2043,1085
99993,2256,1436,417,307,1839,1241
98375,2252,1537,421,318,1831,1334
96801,2295,1537,413,315,1882,1343
95387,2328,1500,399,325,1929,1312
93899,2351,1466,388,345,1963,1284
93291,2300,1405,384,352,1916,1218
95573,2207,1247,367,350,1840,1064
103738,2171,1065,357,331,1814,914
107669,2226,947,392,306,1834,811
107600,2391,908,435,281,1956,784
106526,2595,1012,435,280,2160,873
102820,2583,1044,435,293,2148,903
97452,2392,1053,439,291,1953,935
91842,2285,1038,431,293,1854,939
87775,2219,1042,433,293,1786,945
86068,2154,1089,401,273,1753,991
85649,2017,1074,396,261,1621,962
86072,1809,986,384,248,1425,847
88300,1791,962,407,234,1384,808
93999,1793,991,424,212,1369,836
103504,1818,1059,441,205,1377,889
108933,1902,1116,440,214,1462,927
107357,1851,1090,403,206,1448,910
104010,1800,1093,356,197,1444,926
101057,1694,1205,327,199,1367,1030
98462,1516,1218,300,185,1216,1050
95906,1435,1202,250,121,1185,1093
94145,1412,1182,216,88,1196,1117
92567,1402,1219,187,84,1215,1174
91965,1397,1225,165,89,1232,1184
94047,1487,1224,158,70,1329,1192
101414,1850,1390,220,91,1630,1331
104918,2132,1510,309,144,1823,1406
104460,2233,1579,358,180,1875,1460
102938,2335,1665,373,186,1962,1534
99356,2339,1718,353,220,1986,1562
93344,2388,1721,358,223,2030,1563
87511,2432,1729,365,248,2067,1557
83537,2393,1735,365,255,2028,1547
81639,2375,1792,372,266,2003,1600
80725,2284,1800,359,258,1925,1626
80883,2364,1825,346,254,2018,1635
82874,2360,1822,354,265,2006,1608
88249,2317,1715,355,251,1962,1504
97835,2332,1646,365,244,1967,1444
103438,2394,1637,379,235,2015,1435
102153,2415,1571,395,245,2020,1356
99901,2297,1539,361,259,1936,1313
98477,2098,1607,360,289,1738,1351
96624,2027,1651,361,298,1666,1383
95409,2096,1661,377,311,1719,1384
94371,2237,1663,385,322,1852,1386
93204,2433,1610,393,328,2040,1342
92538,2624,1432,403,294,2221,1202
93934,2752,1291,435,270,2317,1090
100052,2918,1096,488,260,2430,923
102732,3191,1001,535,245,2656,882
101315,3326,1084,589,253,2737,1006
99669,3337,1067,644,234,2693,1031
95674,3217,1033,663,212,2554,1037
89706,3168,1041,659,183,2509,1079
83451,2950,1092,592,170,2358,1162
79181,2995,1202,586,183,2409,1250
77105,2949,1237,626,181,2323,1232
76367,2812,1192,628,149,2184,1155
76743,2568,1313,594,97,1974,1248
78731,2441,1442,590,118,1851,1337
84428,2387,1474,564,146,1823,1345
94342,2400,1443,542,128,1858,1334
100415,2486,1400,504,99,1982,1339
99713,2635,1455,469,98,2166,1383
97922,2741,1442,453,121,2288,1333
96609,2627,1433,390,142,2237,1327
95235,2551,1404,334,192,2217,1275
93845,2657,1415,317,225,2340,1261
92814,2671,1339,294,245,2377,1184
91568,2691,1277,257,224,2434,1154
91319,2677,1247,245,219,2432,1140
93686,2741,1283,270,239,2471,1154
100524,2901,1366,352,290,2549,1197
102801,3056,1394,436,283,2620,1218
101676,3226,1442,490,277,2736,1259
99790,3233,1425,522,271,2711,1229
95745,3309,1395,544,249,2765,1198
89872,3427,1272,539,270,2888,1039
83619,3416,1071,532,279,2884,824
79275,3347,883,518,260,2829,656
77074,3292,908,553,315,2739,629
75910,2941,909,540,335,2401,659
76135,2771,912,563,313,2208,717
77624,2719,1028,566,285,2153,872
82519,2659,1109,576,235,2083,988
91323,2686,1116,600,216,2086,1017
97191,2682,1199,623,185,2059,1092
97297,2708,1248,651,160,2057,1130
96707,2587,1222,651,153,1936,1097
96574,2441,1154,581,134,1860,1093
95959,2343,1161,570,131,1773,1080
95002,2312,1131,553,152,1759,1072
94229,2313,1086,542,132,1771,988
93042,2261,967,509,90,1752,885
92449,2232,931,498,97,1734,836
93710,2336,1003,483,124,1853,931
97387,2566,941,508,160,2058,926
97626,2630,1199,476,148,2154,1165
95448,2702,1410,489,172,2213,1366
93036,2819,1482,506,193,2313,1463
89408,2899,1515,511,207,2388,1505
84553,2930,1551,486,224,2444,1560
78984,2966,1533,464,224,2502,1572
74373,2996,1444,457,237,2539,1497
71230,2937,1443,435,235,2502,1503
69664,2881,1397,441,224,2440,1456
68739,2713,1212,447,195,2266,1237
69142,2669,1010,471,191,2198,1024
70729,2677,894,460,202,2217,945
73805,2849,857,436,202,2413,889
77516,2958,774,428,186,2530,776
80585,3104,722,412,186,2692,655
83077,3177,831,404,190,2773,713
84104,3178,1115,379,200,2799,949
83632,3150,1286,379,231,2771,1077
82260,3136,1316,358,210,2778,1139
80371,3076,1274,332,183,2744,1124
78803,3099,1315,317,173,2782,1171
78464,3078,1479,295,173,2783,1333
80225,3013,1449,273,176,2740,1303
85702,3005,1285,307,217,2698,1138
87740,3105,1145,356,219,2749,1049
86342,3220,1162,403,254,2817,1037
84620,3357,936,428,268,2929,784
82481,3498,715,456,245,3042,579
78773,3571,600,504,244,3067,495
74083,3492,564,552,211,2940,524
70134,3352,594,578,184,2774,561
67495,3298,536,578,182,2720,572
65944,3189,530,585,191,2604,564
65152,3016,626,579,206,2437,696
65141,2778,857,593,190,2185,892
66365,2601,1000,592,187,2009,987
68488,2464,1027,597,201,1867,1006
71717,2301,1008,586,207,1715,963
74969,2306,854,565,198,1741,777
77546,2169,802,492,195,1677,700
78968,2103,855,475,218,1628,711
79915,2077,918,452,210,1625,754
80260,1975,941,422,200,1553,781
80273,2047,960,386,188,1661,808
79918,2098,1038,373,183,1725,923
80096,2046,1013,382,185,1664,873
82526,2037,940,363,192,1674,784
88252,2032,820,362,188,1670,679
90252,2081,722,379,173,1702,608
89273,2324,841,398,175,1926,777
87452,2548,1051,433,171,2115,1019
84104,2494,1111,441,156,2053,1102
79349,2502,1228,466,128,2036,1243
74607,2376,1247,468,115,1908,1257
71013,2271,1372,478,63,1793,1370
69234,2193,1488,507,53,1686,1459
68362,2086,1547,516,71,1570,1482
68616,2002,1536,528,88,1474,1461
70696,1999,1547,538,113,1461,1449
76166,1962,1415,490,126,1472,1313
85566,2010,1375,478,136,1532,1288
92752,2066,1401,472,141,1594,1323
93787,2098,1485,448,124,1650,1428
94159,1982,1560,384,136,1598,1511
94623,1844,1564,328,160,1516,1532
94769,1649,1477,272,162,1377,1442
94391,1534,1377,232,137,1302,1354
93917,1652,1575,210,132,1442,1548
93341,1699,1717,200,104,1499,1670
93424,1725,1862,181,109,1544,1779
95438,1814,1947,177,108,1637,1869
100944,1887,1951,195,104,1692,1868
102890,1923,1994,204,118,1719,1891
101664,1972,2027,221,140,1751,1901
99786,2013,2060,224,160,1789,1918
95709,2019,2053,226,183,1793,1889
90083,2014,2084,233,188,1781,1919
84271,2038,2014,250,165,1788,1871
80204,2116,2014,267,187,1849,1846
78092,2121,2012,288,226,1833,1801
77184,2055,1919,279,219,1776,1715
77529,2108,1809,297,201,1811,1619
79410,2107,1717,293,173,1814,1556
84902,1971,1531,289,168,1682,1376
94494,1911,1436,268,166,1643,1284
101017,1802,1246,232,153,1570,1106
101207,1716,1030,190,115,1526,944
101216,1684,948,168,118,1516,875
101327,1473,888,146,116,1327,831
100857,1384,869,140,100,1244,804
100355,1399,779,152,104,1247,696
99738,1540,871,166,105,1374,796
99113,1559,855,168,103,1391,782
99058,1723,988,171,106,1552,911
101186,1992,1276,205,152,1787,1157
106209,2260,1435,229,177,2031,1285
107807,2370,1544,248,213,2122,1364
106410,2507,1547,259,235,2248,1355
104329,2572,1483,258,226,2314,1311
100293,2737,1495,311,254,2426,1328
93957,2772,1425,312,279,2460,1238
88110,2704,1383,295,285,2409,1200
83843,2690,1325,280,259,2410,1170
81799,2638,1244,282,244,2356,1099
80686,2646,1190,316,257,2330,1052
80717,2753,1162,360,262,2393,1034
82382,2786,1091,384,272,2402,974
87505,2696,964,392,279,2304,898
96574,2603,902,395,272,2208,881
102688,2623,909,395,269,2228,890
103097,2636,869,400,284,2236,884
102743,2580,893,381,274,2199,906
103080,2506,858,377,276,2129,911
102897,2410,694,373,293,2037,826
102103,2391,595,371,305,2020,777
101640,2315,515,372,318,1943,718
100910,2327,460,366,318,1961,686
100608,2400,405,352,316,2048,633
102438,2452,374,335,304,2117,607
106988,2446,220,329,292,2117,426
107907,2466,230,321,262,2145,334
106294,2515,255,342,228,2173,164
103758,2586,357,330,171,2256,218
99297,2616,538,328,149,2288,428
92995,2627,602,336,133,2291,527
86590,2661,588,337,123,2324,532
81956,2701,621,299,135,2402,597
79064,2755,627,292,128,2463,627
77912,2680,656,283,121,2397,654
77622,2612,696,270,144,2342,707
79319,2693,651,271,149,2422,671
84683,2619,614,238,145,2381,704
94096,2600,692,223,159,2377,805
100308,2539,707,194,176,2345,804
100653,2613,837,184,186,2429,869
100399,2715,1060,198,183,2517,995
100270,2794,1139,206,192,2588,1054
99986,2855,1122,207,199,2648,1034
99330,2983,1158,209,221,2774,1039
99231,3095,1106,222,227,2873,976
99019,3267,1031,259,254,3008,877
99354,3366,1097,285,273,3081,909
101288,3302,1135,290,290,3012,945
105856,3279,1174,349,313,2930,949
107825,3267,1287,412,293,2855,1043
106615,3284,1346,421,300,2863,1084
104748,3300,1329,439,293,2861,1070
101084,3355,1274,486,259,2869,1049
95540,3333,1196,527,237,2806,986
89922,3111,1314,547,240,2564,1092
85882,3006,1267,619,194,2387,1084
83971,2851,1223,613,176,2238,1058
83248,2653,1098,603,176,2050,932
83648,2530,1094,619,152,1911,958
85661,2393,1031,625,120,1768,925
91223,2362,971,626,96,1736,893
100371,2413,844,622,90,1791,789
106627,2548,865,611,76,1937,829
106987,2635,930,588,66,2047,922
105338,2671,925,567,85,2104,926
104001,2675,912,541,137,2134,923
102150,2669,874,493,173,2176,894
100217,2694,886,486,205,2208,902
98326,2688,833,423,240,2265,859
96777,2605,740,387,261,2218,773
96088,2416,660,353,264,2063,675
97772,2377,625,381,248,1996,636
103973,2339,660,390,231,1949,673
107724,2379,775,418,205,1961,764
106642,2487,864,454,225,2033,801
105094,2566,966,470,252,2096,874
102208,2574,1043,480,251,2094,965
97638,2636,1078,484,278,2152,981
92402,2647,1117,476,309,2171,1000
88137,2645,1111,480,319,2165,1005
85501,2603,1109,478,335,2125,997
84094,2538,1100,473,331,2065,1014
83518,2471,1101,488,332,1983,1062
83960,2399,1116,498,316,1901,1079
86061,2352,1147,499,301,1853,1121
89123,2477,1133,532,283,1945,1149
92500,2622,1157,581,227,2041,1200
94221,2738,1267,605,198,2133,1294
93991,2766,1319,613,177,2153,1367
92585,2808,1394,621,183,2187,1460
90031,2751,1405,642,194,2109,1451
87080,2712,1410,650,209,2062,1421
84091,2626,1431,650,217,1976,1416
82129,2492,1410,666,201,1826,1392
81085,2497,1403,674,179,1823,1397
82436,2457,1417,674,173,1783,1419
88143,2376,1434,663,214,1713,1387
92312,2477,1504,693,219,1784,1419
91825,2543,1583,707,233,1836,1461
90819,2552,1627,676,277,1876,1460
88629,2525,1662,660,301,1865,1473
85106,2479,1651,631,307,1848,1455
81047,2454,1634,623,298,1831,1441
77536,2476,1726,602,307,1874,1512
75374,2454,1768,575,273,1879,1563
74312,2413,1726,539,252,1874,1544
73944,2434,1694,543,228,1891,1529
74432,2359,1656,545,199,1814,1503
76127,2204,1549,509,188,1695,1405
78802,1958,1428,457,204,1501,1283
81833,1811,1254,414,225,1397,1094
84096,1672,1117,363,238,1309,937
85091,1507,1071,333,254,1174,864
84916,1271,902,313,292,958,645
84125,1219,787,313,332,906,517
83392,1219,822,317,355,902,535
82755,1220,887,321,364,899,553
81899,1235,887,327,371,908,544
81937,1203,842,310,365,893,523
84303,1270,854,280,325,990,675
91092,1315,920,257,285,1058,829
95894,1270,924,247,238,1023,838
95754,1293,904,255,201,1038,797
95069,1353,873,266,194,1087,743
92973,1470,829,281,177,1189,707
90197,1501,859,277,180,1224,774
86395,1445,936,247,146,1198,929
83700,1422,971,210,111,1212,989
82333,1517,1017,204,119,1313,1049
82192,1627,1043,185,121,1442,1077
82882,1611,1030,172,134,1439,1074
85150,1613,1057,161,122,1452,1105
89910,1625,1032,148,112,1477,1092
96785,1636,1019,141,98,1495,1086
102562,1640,991,135,70,1505,1041
104704,1672,1041,125,69,1547,1077
105929,1664,1082,126,64,1538,1106
106306,1589,1098,130,65,1459,1096
105506,1456,1064,136,77,1320,1029
104830,1424,1098,148,78,1276,1072
104268,1464,1114,194,76,1270,1104
102660,1557,1191,230,95,1327,1179
101616,1582,1188,266,102,1316,1163
103186,1536,1205,291,109,1245,1157
109316,1456,1154,308,99,1148,1108
113253,1443,1077,347,118,1096,1019
112905,1522,1010,352,131,1170,944
111762,1687,1018,356,178,1331,952
108359,1793,1092,345,189,1448,1038
103108,1724,1141,319,200,1405,1078
98035,1778,1152,331,238,1447,1065
94984,1751,1072,330,244,1421,988
93847,1743,986,331,221,1412,900
93939,1778,895,329,208,1449,829
94908,1801,838,319,215,1482,797
97844,1782,776,327,225,1455,749
104081,1746,727,336,231,1410,704
113884,1788,700,356,218,1432,687
120127,1800,657,394,201,1406,638
119908,1869,628,411,191,1458,614
118560,1934,626,411,191,1523,617
117608,1910,627,410,193,1500,631
116274,1854,679,403,202,1451,671
115131,1939,786,382,183,1557,762
113769,2077,801,362,191,1715,749
112496,2203,850,348,194,1855,803
112212,2292,898,343,178,1949,864
114972,2347,948,359,156,1988,933
122198,2380,1010,370,129,2010,1003
126725,2425,1084,389,86,2036,1102
126248,2427,1173,378,52,2049,1181
124601,2389,1239,356,89,2033,1209
120802,2340,1280,350,108,1990,1231
114612,2327,1286,338,114,1989,1239
109035,2282,1238,322,118,1960,1191
105396,2288,1182,329,129,1959,1148
103520,2284,1139,334,165,1950,1112
102827,2108,1077,315,184,1793,1066
103157,2006,973,323,196,1683,962
105349,1959,897,305,186,1654,924
110841,1944,928,298,192,1646,989
119944,1935,995,287,193,1648,1060
125080,1947,1080,290,188,1657,1120
123613,1983,1170,286,182,1697,1179
120946,2051,1221,316,192,1735,1191
119254,2085,1246,347,197,1738,1176
117674,2071,1235,357,203,1714,1143
116313,2075,1216,377,204,1698,1089
115164,2143,1288,394,217,1749,1158
114298,2101,1267,399,216,1702,1132
114002,2070,1307,410,224,1660,1170
115796,1928,1192,387,204,1541,1058
121410,1926,1176,390,206,1536,1059
124342,1896,1139,398,219,1498,1026
123278,2019,1035,401,233,1618,915
121179,2138,912,417,242,1721,787
117066,2311,817,406,239,1905,737
110607,2434,662,404,219,2030,607
104237,2440,421,367,189,2073,425
100353,2403,460,331,192,2072,502
98425,2342,483,322,198,2020,526
97887,2237,488,290,184,1947,515
98430,2291,587,312,229,1979,570
100389,2282,694,340,257,1942,627
106095,2342,769,348,252,1994,681
115100,2341,847,339,223,2002,753
120866,2389,837,331,205,2058,719
120779,2227,746,329,185,1898,635
118855,2071,667,347,137,1724,574
117399,1861,671,354,106,1507,607
115682,1825,627,387,71,1438,623
114057,1819,523,408,131,1411,602
112983,1990,698,445,154,1545,768
111799,2082,804,480,190,1602,812
111285,2127,913,496,210,1631,874
113488,2062,885,494,236,1568,879
120238,2012,869,481,198,1531,877
124478,2187,898,521,182,1666,912
124158,2446,1014,564,181,1882,998
123019,2581,1042,579,161,2002,1005
119201,2499,1065,565,146,1934,1021
113470,2431,1101,550,162,1881,1043
107689,2358,1088,537,168,1821,1025
103671,2202,1071,510,166,1692,1002
101645,2121,1068,493,193,1628,992
100910,1978,974,434,184,1544,926
101102,1881,930,386,174,1495,898
102809,1811,890,369,198,1442,855
107731,1734,887,332,214,1402,853
116228,1744,881,304,187,1440,845
121464,1734,1030,296,224,1438,949
121266,1730,1101,269,203,1461,1016
120878,1837,1257,241,210,1596,1135
120606,1899,1267,222,218,1677,1122
119846,1989,1268,217,217,1772,1129
118743,2129,1311,215,234,1914,1156
117535,2198,1336,182,237,2016,1174
116686,2299,1291,175,222,2124,1140
116183,2419,1289,175,234,2244,1137
116878,2597,1324,192,238,2405,1172
120767,2737,1232,217,226,2520,1069
122595,2844,1184,239,242,2605,997
120306,2842,1405,290,304,2552,1168
117541,2756,1485,337,326,2419,1222
113346,2755,1501,347,331,2408,1260
107904,2712,1501,377,341,2335,1290
102009,2566,1492,410,336,2156,1309
97934,2305,1567,415,328,1890,1372
95597,2194,1631,420,309,1774,1428
94311,2233,1644,414,312,1819,1410
93835,2246,1657,395,288,1851,1418
94506,2320,1757,413,282,1907,1501
96252,2224,1791,442,269,1782,1558
99556,2188,1780,428,256,1760,1557
103092,2184,1833,412,236,1772,1611
105964,2076,1787,378,203,1698,1589
107306,2004,1785,363,206,1641,1600
106536,1953,1951,332,251,1621,1752
104580,1993,2037,320,271,1673,1831
101999,1995,2008,330,272,1665,1796
99325,2036,1997,378,268,1658,1791
97644,2068,1966,415,255,1653,1752
97161,2114,1970,424,245,1690,1756
98921,2104,1928,459,237,1645,1705
104329,1896,1736,441,222,1455,1534
108307,1937,1678,421,211,1516,1479
107841,2028,1638,428,210,1600,1440
106511,2017,1459,438,227,1579,1248
104065,2056,1300,420,196,1636,1107
100204,1985,1124,395,186,1590,941
96128,1988,1061,382,187,1606,881
92722,2112,1126,394,181,1718,948
90970,2201,1161,435,218,1766,951
90315,2139,1332,470,245,1669,1091
90154,2184,1493,480,242,1704,1256
90856,2227,1514,480,253,1747,1266
92785,2175,1448,468,269,1707,1191
95917,2061,1394,458,261,1603,1145
98944,1988,1357,473,270,1515,1111
100626,1995,1389,491,286,1504,1150
99730,1856,1406,489,290,1367,1170
97942,1812,1389,480,274,1332,1188
96041,1854,1385,475,271,1379,1220
94243,1922,1401,460,294,1462,1245
92428,1968,1387,455,299,1513,1258
91486,1983,1314,437,282,1546,1215
91807,2056,1275,427,286,1629,1205
94609,2099,1200,401,287,1698,1145
101270,2208,1056,391,290,1817,1054
105917,2314,917,413,282,1901,990
105659,2427,904,414,253,2013,1033
104508,2615,951,415,249,2200,1104
101183,2616,989,425,222,2191,1144
96361,2532,1082,432,216,2100,1233
91619,2553,1110,430,179,2123,1236
88199,2579,1110,421,166,2158,1231
86083,2536,1100,463,154,2073,1196
85091,2380,1074,443,132,1937,1162
85107,2360,1119,430,125,1930,1206
86652,2382,1170,401,123,1981,1225
91656,2455,1288,360,150,2095,1310
99911,2616,1364,355,176,2261,1362
105907,2732,1263,383,182,2349,1255
107554,2858,1153,402,161,2456,1139
107874,2730,1106,344,169,2386,1054
107673,2540,1020,333,161,2207,965
106927,2474,852,314,137,2160,807
105576,2480,777,324,125,2156,722
104146,2543,815,336,139,2207,747
102282,2568,903,337,182,2231,790
101107,2621,964,352,199,2269,839
101673,2544,1001,336,191,2208,880
105310,2592,1066,378,197,2214,910
107273,2695,1107,426,218,2269,932
105498,2817,1107,449,220,2368,929
102890,2857,1062,446,217,2411,895
97846,2967,998,423,222,2544,841
91173,3002,905,400,217,2602,765
84886,3105,812,388,213,2717,704
80294,3181,654,379,191,2802,589
77716,3176,456,397,154,2779,496
76348,3067,527,388,122,2679,539
75971,2937,462,378,87,2559,497
77437,2867,322,400,120,2467,407
82505,2824,338,401,126,2423,373
91346,2935,358,445,170,2490,446
96532,3107,645,476,203,2631,689
95859,3068,808,477,235,2591,817
94446,3006,924,480,237,2526,940
93305,2987,942,506,228,2481,1014
91861,3038,968,542,191,2496,1059
90643,3202,959,584,173,2618,1073
90009,3305,772,602,169,2703,916
88941,3253,695,626,155,2627,804
88388,3135,630,637,156,2498,716
89121,2916,516,570,189,2346,545
93517,2723,640,537,225,2186,540
96604,2957,827,576,196,2381,724
95617,3114,913,611,186,2503,856
93346,3149,1063,606,180,2543,1014
89211,3222,1162,623,163,2599,1128
83270,3181,1267,612,144,2569,1260
77259,3229,1273,609,140,2620,1285
72746,3158,1165,586,136,2572,1239
70342,3071,1219,561,142,2510,1328
68956,3010,1130,489,132,2521,1243
68819,2930,1071,441,146,2489,1160
70127,2879,925,429,163,2450,989
74842,2921,825,442,185,2479,891
84037,2813,853,453,187,2360,957
89923,2806,743,474,199,2332,848
90204,2751,436,459,220,2292,456
90285,2735,411,435,242,2300,369
90538,2608,508,408,284,2200,425
90819,2519,710,400,296,2119,668
90551,2581,920,420,295,2161,864
90275,2476,975,436,303,2040,926
89794,2408,868,461,248,1947,906
89884,2269,806,428,240,1841,940
91475,2410,986,436,273,1974,1127
95453,2474,1019,499,283,1975,1155
97349,2537,933,573,238,1964,1099
96464,2627,866,621,207,2006,1016
94300,2772,871,676,173,2096,984
90458,2848,880,701,119,2147,976
85116,3003,907,723,108,2280,993
79610,3167,882,754,86,2413,949
75581,3362,793,744,85,2618,848
73296,3531,803,727,101,2804,850
72268,3537,635,719,114,2818,689
72234,3433,537,699,89,2734,572
74078,3378,690,714,60,2664,708
80612,3315,800,702,61,2613,798
89972,3272,936,695,98,2577,904
97226,3239,1013,691,116,2548,978
98634,3160,1116,646,142,2514,1051
99363,3060,1199,593,160,2467,1104
100003,2912,1211,592,185,2320,1114
99883,2720,1126,554,191,2166,1048
99380,2631,1115,516,210,2115,1030
99287,2553,1143,480,223,2073,1051
99074,2528,1195,460,235,2068,1066
99327,2603,1201,479,211,2124,1070
101574,2541,1221,440,192,2101,1104
107020,2576,1307,446,190,2130,1176
111991,2641,1314,493,195,2148,1154
112127,2775,1473,513,202,2262,1293
110786,2886,1560,547,231,2339,1344
107303,2936,1623,554,255,2382,1397
101493,2915,1615,547,257,2368,1404
96166,2790,1524,534,266,2256,1324
92428,2598,1413,518,256,2080,1215
90767,2385,1277,457,254,1928,1104
90092,2266,1157,448,267,1818,1004
90362,2228,1095,459,266,1769,963
92295,2205,1040,465,240,1740,919
97649,2039,952,452,203,1587,845
107046,1978,793,469,186,1509,738
113057,1881,690,487,191,1394,652
113909,1859,738,464,202,1395,731
113811,1785,839,445,244,1340,829
113248,1653,814,459,276,1194,790
111991,1547,780,459,302,1088,711
110583,1569,816,469,314,1100,687
109393,1594,946,453,322,1141,762
108254,1569,920,429,305,1140,788
107469,1580,912,428,292,1152,838
109066,1601,1020,414,274,1187,914
114155,1705,1086,446,271,1259,983
118740,1677,1134,455,276,1222,1081
117895,1822,1362,466,260,1356,1283
116318,1916,1519,470,262,1446,1404
113615,1963,1479,464,251,1499,1345
109302,1975,1496,427,256,1548,1328
104249,1936,1518,379,250,1557,1353
100364,1969,1482,356,253,1613,1318
98432,1996,1446,334,242,1662,1276
97301,2047,1432,334,237,1713,1266
97080,2029,1303,325,209,1704,1154
97659,2105,1178,282,171,1823,1068
99859,2264,1214,256,170,2008,1153
103197,2293,1311,232,165,2061,1262
106533,2346,1407,234,148,2112,1341
108035,2410,1550,228,144,2182,1479
108348,2269,1524,250,164,2019,1469
107962,2165,1431,268,150,1897,1382
106590,2044,1401,276,151,1768,1383
104640,2007,1423,303,191,1704,1415
102692,1969,1460,358,254,1611,1454
101174,1994,1385,412,288,1582,1364
100940,1997,1364,439,284,1558,1329
102516,2033,1382,461,300,1572,1301
106426,1956,1220,480,307,1476,1109
109361,1881,1066,509,314,1372,917
108595,1837,1069,522,344,1315,849
106958,1883,1074,554,350,1329,797
104019,1833,1192,547,350,1286,887
99480,1587,1054,536,365,1051,705
94648,1462,1017,516,380,946,655
90598,1363,1019,476,375,887,658
88209,1368,1060,433,356,935,717
86774,1439,1178,406,356,1033,836
86539,1574,1358,366,350,1208,1032
87008,1685,1531,349,339,1336,1216
88648,1830,1847,339,356,1491,1504
91265,1903,1973,336,359,1567,1622
94245,1887,1926,327,346,1560,1590
97149,1806,1876,322,358,1484,1521
99124,1701,1752,266,290,1435,1469
99351,1788,1777,245,272,1543,1522
98543,1847,1880,268,290,1579,1631
97477,1846,1915,257,278,1589,1678
96389,1892,1963,253,273,1639,1732
95695,1936,1959,254,252,1682,1741
96087,1907,1882,231,222,1676,1679
98085,1865,1793,211,193,1654,1606
102873,1853,1680,230,194,1623,1494
105766,1971,1539,262,207,1709,1365
104198,2126,1405,319,211,1807,1274
103111,2119,1384,337,230,1782,1248
101408,2189,1374,367,268,1822,1232
97958,2185,1345,384,292,1801,1202
94974,2106,1264,376,287,1730,1148
91431,2043,1295,364,270,1679,1181
89933,1972,1240,352,265,1620,1138
89548,1959,1192,332,270,1627,1063
90336,1994,1127,345,289,1649,961
92991,2091,1068,383,294,1708,870
98829,2028,946,388,278,1640,753
108361,1843,815,384,276,1459,631
113504,1851,816,410,301,1441,603
113091,1943,720,416,307,1527,494
111801,1717,635,361,279,1356,493
110838,1581,485,324,250,1257,437
109138,1327,466,278,225,1049,412
107419,1163,507,244,180,919,469
106254,1148,487,209,159,939,449
105084,1265,510,199,153,1066,428
104646,1327,541,174,144,1153,456
105757,1388,543,152,152,1236,424
110132,1481,677,142,161,1339,535
114573,1635,848,133,149,1502,723
113939,1779,1039,140,148,1639,921
111452,1852,1124,142,128,1710,1022
106895,1924,1244,147,117,1777,1149
100250,1973,1256,144,84,1829,1182
93852,1974,1219,163,81,1811,1147
89539,1933,1222,169,93,1764,1137
87225,2070,1334,226,186,1844,1196
86007,2145,1341,268,213,1877,1172
85953,2119,1337,278,221,1841,1174
87926,2001,1348,307,275,1694,1164
93044,1910,1248,300,278,1610,1070
102080,1743,1158,287,271,1456,1003
107541,1702,1138,332,310,1370,969
107209,1675,1079,344,328,1331,949
106606,1539,1033,306,330,1233,965
105839,1499,993,316,337,1183,972
104711,1531,945,343,358,1188,957
103302,1533,947,340,347,1193,961
102254,1564,962,356,342,1208,945
101475,1650,987,372,328,1278,932
100876,1701,988,385,311,1316,938
102012,1655,940,375,284,1280,867
105809,1499,832,351,242,1148,747
109960,1469,834,325,216,1144,730
109562,1516,843,326,206,1190,716
107610,1524,865,328,203,1196,710
103493,1477,933,337,209,1140,757
97243,1591,1165,323,196,1268,986
90921,1687,1256,331,197,1356,1081
86821,1753,1329,354,202,1399,1155
84652,1748,1486,352,207,1396,1301
83914,1684,1463,361,204,1323,1283
84064,1790,1444,374,213,1416,1282
86160,1804,1427,392,218,1412,1267
91766,1828,1321,417,222,1411,1159
101506,1756,1114,427,209,1329,973
106816,1680,950,436,194,1244,835
105616,1555,896,406,173,1149,805
103415,1408,898,384,204,1024,776
101762,1294,914,345,190,949,792
99973,1316,811,344,177,972,707
98581,1365,623,343,187,1022,546
97341,1341,547,325,198,1016,521
95834,1388,555,305,197,1083,531
94827,1397,530,270,177,1127,473
95860,1390,638,251,170,1139,541
100892,1478,845,236,150,1242,733
106892,1683,825,249,158,1434,740
107784,1994,863,291,205,1703,773
106839,2114,929,327,230,1787,810
103582,2201,816,371,196,1830,729
98316,2388,730,392,191,1996,656
92704,2593,801,404,224,2189,695
89057,2572,1175,400,231,2172,1037
87191,2533,1406,389,216,2144,1269
86624,2539,1395,397,202,2142,1286
86965,2510,1319,395,172,2115,1263
89024,2305,1138,401,133,1904,1107
94705,2129,971,389,104,1740,967
103984,2102,1068,360,128,1742,1099
109021,2169,1150,339,150,1830,1188
108222,2285,1290,330,140,1955,1333
106695,2171,1241,291,136,1880,1289
105366,1921,1146,258,137,1663,1201
103341,1908,1231,246,137,1662,1270
101499,1880,1298,241,153,1639,1314
99998,1789,1228,211,133,1578,1274
98770,1734,1081,231,140,1503,1173
98100,1790,1013,241,160,1549,1127
99279,1787,954,248,179,1539,1082
103209,1824,902,253,196,1571,1026
107326,1929,846,271,229,1658,942
107147,2088,1007,327,266,1761,1020
105317,2219,1172,355,287,1864,1124
101667,2303,1214,367,304,1936,1081
95564,2418,1314,390,315,2028,1115
89432,2313,1404,377,302,1936,1189
85107,2246,1465,381,287,1865,1253
82690,2196,1462,378,281,1818,1253
81684,2190,1586,364,277,1826,1364
81487,2180,1705,358,280,1822,1456
83414,2142,1667,349,272,1793,1430
88653,2047,1464,348,256,1699,1268
97643,2023,1352,340,224,1683,1194
103611,2009,1312,319,183,1690,1169
103941,1892,1240,282,162,1610,1098
104414,1776,1172,254,154,1522,1029
104569,1689,1143,231,149,1458,1000
104171,1574,1117,195,133,1379,998
103083,1437,1023,151,105,1286,936
102471,1398,1023,131,97,1267,943
101322,1396,1081,137,108,1259,994
100772,1323,1033,157,143,1166,932
101671,1340,910,160,152,1180,825
104586,1388,891,148,144,1240,853
107204,1485,990,170,136,1315,984
105956,1581,1087,189,133,1392,1073
103909,1594,1009,211,134,1383,1018
100860,1655,960,236,150,1419,1012
96506,1691,882,261,168,1430,960
91448,1708,839,304,241,1404,931
87453,1740,848,325,258,1415,938
85441,1761,834,325,266,1436,920
84557,1742,844,315,273,1427,924
84575,1696,830,301,294,1395,909
85575,1658,811,303,322,1355,884
87961,1626,841,303,327,1323,914
91899,1611,834,296,341,1315,896
95570,1655,825,283,335,1372,884
98219,1736,947,265,323,1471,1009
99232,1792,958,255,312,1537,1011
98671,1891,950,247,299,1644,961
96626,1937,1088,227,276,1710,1056
93965,1939,1104,234,256,1705,1035
91121,1928,1172,244,245,1684,1081
88529,1985,1230,242,223,1743,1133
87296,2044,1157,246,205,1798,1055
87999,2094,1146,250,183,1844,1048
92600,2056,1176,254,188,1802,1060
99229,2085,1154,269,174,1816,1033
99987,2200,1110,292,170,1908,975
99414,2352,1059,326,183,2026,914
97574,2380,1176,337,199,2043,1010
94466,2382,1125,335,195,2047,975
90732,2423,1147,325,198,2098,992
87577,2276,1159,326,228,1950,982
85865,2169,1210,319,241,1850,1022
85094,2143,1286,316,264,1827,1103
85008,2187,1288,323,271,1864,1084
85903,2245,1251,337,246,1908,1041
87667,2169,1162,324,234,1845,953
90601,2063,1096,323,233,1740,875
93149,2002,1090,305,221,1697,876
94312,1880,1056,275,221,1605,845
93860,1753,1066,262,229,1491,845
92460,1559,1073,256,242,1303,842
90523,1416,1052,240,229,1176,854
88494,1389,1015,226,214,1163,842
86284,1445,1003,239,222,1206,831
85398,1557,1046,273,240,1284,874
84257,1607,1046,285,240,1322,888
86509,1617,999,272,247,1345,834
92279,1696,1022,275,261,1421,865
97530,1778,1010,300,299,1478,843
97505,1992,858,314,308,1678,739
95960,2154,709,338,318,1816,627
92515,2144,681,364,322,1780,608
87711,2155,672,374,320,1781,646
83068,2172,732,395,335,1777,681
79042,2221,667,396,345,1825,637
77006,2190,658,377,320,1813,658
76247,2038,874,344,290,1694,832
76456,2000,880,308,274,1692,845
78221,2004,911,292,267,1712,873
83632,2006,961,284,277,1722,919
93093,2011,1067,268,293,1743,1042
98755,2031,1083,272,299,1759,1070
99151,2030,1080,275,306,1755,1071
98879,2054,1164,280,323,1774,1185
98782,2136,1200,310,329,1826,1218
98047,2238,1256,356,327,1882,1254
97140,2317,1297,390,309,1927,1271
96093,2451,1355,398,309,2053,1351
94988,2570,1436,426,327,2144,1431
94232,2607,1454,449,334,2158,1447
95033,2597,1446,452,321,2145,1446
98286,2540,1441,444,298,2096,1444
102129,2474,1380,451,268,2023,1373
101613,2528,1329,481,251,2047,1325
99464,2607,1334,495,265,2112,1295
95342,2628,1275,474,251,2154,1242
89421,2687,1244,496,258,2191,1194
83434,2687,1270,482,247,2205,1207
79239,2644,1326,458,230,2186,1242
77150,2703,1450,418,243,2285,1334
76466,2482,1342,385,245,2097,1256
76805,2434,1316,369,250,2065,1230
78842,2374,1253,389,240,1985,1174
84791,2265,1189,384,246,1881,1153
94681,2203,1240,397,236,1806,1214
99800,2220,1173,420,208,1800,1209
99045,2262,1147,417,217,1845,1183
97725,2369,1048,406,240,1963,1051
96846,2526,988,419,244,2107,1004
95431,2608,1014,437,236,2171,1068
93846,2617,1140,437,218,2180,1167
92530,2626,1246,443,189,2183,1283
91091,2550,1282,420,179,2130,1317
90242,2492,1199,447,207,2045,1267
91101,2451,1173,493,241,1958,1281
95006,2349,1288,495,245,1854,1392
100667,2344,1376,539,239,1805,1465
101477,2352,1490,561,226,1791,1526
100511,2356,1569,582,236,1774,1564
97229,2329,1626,590,235,1739,1589
91825,2238,1641,588,241,1650,1576
86224,2170,1541,568,239,1602,1474
82236,2122,1388,564,240,1558,1335
80379,2051,1319,552,254,1499,1256
79690,1971,1300,562,266,1409,1173
80148,1870,1242,561,276,1309,1076
82175,1814,1153,564,269,1250,975
87994,1723,992,556,274,1167,789
97939,1638,865,535,266,1103,649
102822,1622,768,517,266,1105,544
101896,1674,652,500,284,1174,402
100614,1721,609,485,279,1236,376
100075,1673,654,465,276,1208,447
98811,1642,652,426,278,1216,462
97373,1746,624,403,288,1343,439
96483,1879,621,428,294,1451,456
95862,1959,606,452,305,1507,442
96281,2045,639,458,307,1587,527
97909,2059,707,435,309,1624,637
101456,2051,694,406,295,1645,641
105007,2066,762,406,278,1660,691
105462,2157,853,440,287,1717,754
103999,2255,1005,442,291,1813,918
100680,2313,1067,474,264,1839,996
94984,2448,1027,481,251,1967,981
88910,2588,1057,519,240,2069,1033
84631,2652,1162,536,236,2116,1082
82447,2719,1289,536,251,2183,1156
81759,2708,1322,522,256,2186,1199
82124,2684,1350,508,248,2176,1226
84229,2685,1452,484,256,2201,1305
89930,2665,1472,469,258,2196,1310
99880,2516,1303,435,262,2081,1157
104334,2430,1272,353,223,2077,1180
102752,2442,1266,318,252,2124,1223
100675,2509,1309,301,284,2208,1306
99183,2418,1293,282,297,2136,1316
97307,2441,1347,276,319,2165,1360
95143,2470,1377,283,331,2187,1376
93792,2575,1402,282,324,2293,1394
92229,2643,1366,286,326,2357,1333
91391,2677,1337,273,319,2404,1316
92160,2709,1399,273,286,2436,1337
95415,2668,1408,238,217,2430,1306
100979,2660,1292,253,187,2407,1174
101577,2574,1232,308,223,2266,1063
100531,2495,1136,351,281,2144,920
97698,2538,1092,395,328,2143,811
92435,2364,1030,409,331,1955,749
87235,2250,865,439,338,1811,622
83418,2101,765,448,328,1653,615
81455,2038,670,465,322,1573,586
80691,2030,647,466,309,1564,628
81065,1983,608,471,308,1512,631
83220,1846,575,446,300,1400,572
88594,1688,512,422,289,1266,508
97639,1587,508,412,277,1175,514
102168,1518,605,418,272,1100,572
101086,1432,595,418,241,1014,555
98773,1313,486,438,224,875,504
96857,1237,412,446,233,791,449
94843,1257,291,447,241,810,394
93377,1269,268,452,259,817,402
92197,1261,303,462,279,799,359
91129,1299,442,452,311,847,383
90357,1317,502,447,335,870,407
91045,1313,508,458,343,855,432
94017,1381,549,465,352,916,456
98256,1437,548,482,347,955,509
98219,1503,580,480,339,1023,549
96976,1577,562,490,345,1087,515
94466,1501,548,474,345,1027,477
90462,1443,525,444,332,999,476
85629,1438,532,421,306,1017,484
81866,1406,515,399,298,1007,458
79875,1340,452,379,280,961,419
78865,1323,442,366,285,957,362
78713,1323,391,382,246,941,332
79636,1262,425,372,209,890,369
81920,1226,564,363,192,863,470
85653,1231,701,344,183,887,587
89180,1230,749,329,185,901,641
92564,1240,698,291,139,949,617
94732,1254,646,253,86,1001,608
95461,1239,528,251,83,988,509
95225,1255,528,245,141,1010,519
94311,1219,518,238,186,981,510
93095,1233,633,233,215,1000,599
92439,1324,762,223,205,1101,731
92601,1297,776,223,206,1074,773
94155,1222,677,230,165,992,715
97682,1186,620,250,117,936,659
101767,1194,599,278,100,916,621
102085,1243,535,320,117,923,535
100981,1316,586,341,139,975,550
98760,1339,575,360,164,979,512
95440,1335,645,359,181,976,525
91449,1298,741,344,238,954,536
88401,1342,793,327,245,1015,568
86609,1397,838,311,193,1086,655
85959,1411,877,288,176,1123,712
85942,1433,889,274,170,1159,740
86963,1393,775,273,167,1120,657
88984,1346,545,260,160,1086,502
92001,1445,596,259,157,1186,608
94529,1556,812,264,162,1292,818
96594,1556,762,255,176,1301,796
97521,1588,758,247,208,1341,834
97207,1475,627,265,226,1210,711
96626,1590,653,318,255,1272,744
96233,1710,591,336,281,1374,670
95181,1855,588,363,283,1492,636
94214,2006,657,391,277,1615,658
94094,2033,690,411,268,1622,661
95888,2123,790,421,274,1702,727
100423,2125,822,427,283,1698,701
107178,2056,903,447,287,1609,739
108659,2319,1041,489,298,1830,814
108124,2601,1137,551,292,2050,914
105735,2703,1187,582,288,2121,956
102134,2736,1161,565,283,2171,942
98447,2610,1164,555,290,2055,924
95490,2595,1236,530,312,2065,959
94319,2478,1243,494,301,1984,982
94126,2470,1226,479,294,1991,962
94690,2334,1027,441,284,1893,769
96856,2289,836,434,267,1855,602
101430,2221,722,415,251,1806,560
108350,2370,629,387,227,1983,551
111843,2498,445,364,204,2134,434
111449,2589,457,348,224,2241,486
109654,2677,718,321,225,2356,739
107657,2692,693,284,215,2408,715
104646,2817,642,270,203,2547,670
101528,2957,734,278,224,2679,733
98747,3048,852,298,269,2750,854
96380,3098,981,302,283,2796,969
95121,3177,1084,327,245,2850,1105
95828,3256,1048,353,224,2903,1072
99879,3293,1000,371,183,2922,1079
105965,3321,1019,388,137,2933,1093
106560,3379,1003,422,160,2957,1035
105198,3370,1007,433,220,2937,998
100924,3411,1104,441,270,2970,1060
94999,3413,1184,470,289,2943,1134
89080,3371,1221,499,272,2872,1151
85083,3386,1298,509,289,2877,1179
82912,3359,1352,523,300,2836,1216
82155,3376,1392,540,279,2836,1235
82361,3304,1387,553,267,2751,1215
84641,3350,1446,540,243,2810,1262
90243,3380,1462,544,238,2836,1256
99555,3340,1436,546,236,2794,1230
104456,3305,1469,554,252,2751,1253
104401,3164,1460,534,244,2630,1250
103898,2968,1480,515,248,2453,1263
104498,2826,1477,516,266,2310,1252
104372,2597,1370,507,280,2090,1131
104251,2605,1331,533,299,2072,1074
103601,2595,1343,557,301,2038,1089
102569,2633,1299,583,306,2050,1049
102150,2710,1320,618,312,2092,1063
103330,2768,1467,626,310,2142,1232
105972,2786,1645,641,315,2145,1435
109459,2800,1761,663,317,2137,1566
109591,2872,1758,696,306,2176,1562
107751,2870,1765,689,300,2181,1577
103899,2874,1761,666,282,2208,1581
98195,2914,1756,656,266,2258,1587
92737,2897,1773,614,253,2283,1603
89080,2782,1808,578,273,2204,1613
87542,2707,1711,559,313,2148,1497
87019,2686,1569,558,338,2128,1353
87653,2765,1399,550,321,2215,1225
90127,2844,1415,568,300,2276,1276
96275,3022,1526,578,289,2444,1423
106242,3004,1486,583,268,2421,1378
110815,2968,1443,583,231,2385,1314
110086,2952,1378,583,219,2369,1265
108657,2850,1280,576,229,2274,1152
107271,2763,1029,552,226,2211,928
106186,2609,735,512,242,2097,698
104753,2539,649,481,268,2058,626
103762,2608,629,487,294,2121,547
102739,2720,528,511,336,2209,424
102310,2787,523,507,358,2280,437
103675,2851,609,515,374,2336,552
107830,2699,625,501,377,2198,646
114010,2661,627,498,374,2163,686
115144,2731,503,538,369,2193,629
113834,2865,480,575,344,2290,598
110180,2966,497,621,324,2345,542
104412,3090,695,619,289,2471,714
98837,3133,837,647,263,2486,847
94789,2981,932,643,227,2338,911
92814,3018,1070,658,210,2360,1074
92331,3081,1150,672,176,2409,1184
92701,2823,1119,658,204,2165,1146
94774,2527,1153,635,222,1892,1136
100583,2301,1048,632,212,1669,1031
110136,2189,1022,620,262,1569,990
114003,2187,1053,617,291,1570,1029
112663,2331,1058,591,298,1740,1048
110664,2327,1246,611,309,1716,1184
108994,2384,1496,656,328,1728,1346
107001,2324,1400,629,307,1695,1247
104741,2356,1324,587,286,1769,1195
102932,2491,1330,564,288,1927,1205
100867,2495,1228,523,273,1972,1131
100090,2385,1196,479,235,1906,1143
101073,2454,1135,467,204,1987,1105
104930,2449,1022,456,134,1993,1002
111135,2408,959,433,120,1975,939
112288,2403,962,434,153,1969,943
110959,2374,1035,442,205,1932,1009
107374,2339,1118,410,234,1929,1087
101655,2389,1172,386,243,2003,1104
95765,2441,1268,388,240,2053,1147
91822,2377,1135,405,231,1972,1001
89703,2125,859,374,213,1751,708
88806,2012,816,352,209,1660,674
88647,1860,807,354,216,1506,666
90529,1682,793,336,208,1346,635
95340,1541,749,329,208,1212,614
103288,1443,740,315,227,1128,602
107678,1417,741,339,281,1078,565
108140,1293,780,333,318,960,564
107959,1240,750,338,352,902,557
107583,1216,722,339,339,877,581
106321,1320,697,351,326,969,564
104769,1442,800,346,311,1096,752
103392,1485,909,323,302,1162,907
101787,1510,925,298,274,1212,962
101299,1569,963,283,251,1286,1001
101952,1539,973,243,202,1296,974
103560,1491,971,225,130,1266,969
105855,1464,886,226,101,1238,890
104886,1529,726,254,99,1275,742
102430,1738,650,293,80,1445,667
99026,1834,592,336,55,1498,607
94287,1860,547,346,58,1514,562
88646,1919,598,367,57,1552,591
84186,1954,581,372,69,1582,536
81492,1889,512,367,110,1522,456
79995,1814,431,376,122,1438,376
79496,1800,444,373,100,1427,410
79667,1689,453,349,114,1340,436
81443,1608,494,350,144,1258,450
84661,1546,485,331,164,1215,430
88003,1466,454,309,197,1157,352
91559,1319,306,304,211,1015,187
94274,1284,288,320,209,964,236
95012,1258,302,325,200,933,323
94175,1320,333,321,201,999,396
92313,1364,298,293,213,1071,420
89908,1401,340,281,222,1120,451
87704,1526,454,305,210,1221,517
86574,1607,481,324,207,1283,555
86815,1627,509,306,234,1321,568
88987,1741,647,283,219,1458,684
93134,1913,857,270,192,1643,856
93696,2100,1086,244,185,1856,1056
92444,2125,1028,239,162,1886,991
90199,2303,993,256,165,2047,969
86598,2481,971,286,199,2195,884
82298,2588,1009,289,225,2299,904
78774,2603,1071,262,228,2341,1036
76367,2632,1094,257,230,2375,1079
75262,2621,1111,277,217,2344,1111
75019,2752,1113,298,206,2454,1118
75415,2896,1038,305,195,2591,1061
76960,3073,1021,335,215,2738,1073
79509,3131,1028,370,220,2761,1095
81694,3118,1045,401,198,2717,1096
84218,3070,1102,428,193,2642,1154
85284,3142,1177,455,202,2687,1241
85271,3145,1247,459,195,2686,1282
84845,3198,1242,481,187,2717,1273
83999,3282,1209,537,178,2745,1206
82909,3359,1158,597,159,2762,1157
81888,3386,1162,638,170,2748,1171
81952,3353,1162,652,157,2701,1182
83515,3296,1182,651,151,2645,1204
87592,3173,1191,635,151,2538,1236
94007,3025,1166,551,172,2474,1285
96796,3070,1260,592,124,2478,1361
96323,3112,1464,601,87,2511,1494
93728,3167,1595,596,97,2571,1563
89819,3169,1602,619,124,2550,1560
85912,3116,1608,572,157,2544,1553
83056,3093,1675,556,159,2537,1584
81727,3037,1582,548,148,2489,1484
81655,2920,1537,513,155,2407,1426
82423,2704,1531,501,154,2203,1412
85436,2559,1510,489,171,2070,1388
91654,2480,1524,487,190,1993,1395
101597,2521,1526,494,233,2027,1363
105704,2483,1450,491,260,1992,1269
104214,2497,1506,476,288,2021,1292
101703,2361,1524,477,281,1884,1313
99680,2306,1555,501,262,1805,1378
97704,2212,1547,492,248,1720,1376
95590,2137,1470,482,251,1655,1276
94336,2133,1462,482,265,1651,1240
92801,2141,1507,470,275,1671,1279
91869,2053,1473,434,288,1619,1242
92241,1992,1361,399,304,1593,1141
95400,2010,1215,387,319,1623,1021
102187,2156,1102,402,326,1754,949
104257,2295,919,430,329,1865,837
103374,2419,870,454,304,1965,863
100094,2509,848,471,287,2038,860
94747,2699,982,505,277,2194,944
89185,2849,1041,523,268,2326,996
85418,2939,1004,525,251,2414,984
83660,2991,908,530,254,2461,885
83230,3010,928,527,249,2483,861
83347,2911,1000,520,231,2391,932
85379,2827,989,522,219,2305,912
90803,2698,913,489,231,2209,812
99944,2528,852,474,258,2054,759
104410,2505,815,478,267,2027,752
104167,2441,844,473,294,1968,803
103613,2275,946,470,317,1805,900
103450,2180,919,459,342,1721,872
102814,2199,887,461,361,1738,810
102657,2201,842,455,370,1746,703
102506,2243,718,433,360,1810,560
101865,2393,615,410,335,1983,484
101747,2455,557,369,304,2086,491
102665,2396,553,338,308,2058,530
105182,2181,643,303,272,1878,661
108004,1977,652,282,257,1695,680
107146,1981,631,301,242,1680,657
104363,1996,601,321,231,1675,614
99568,2092,618,325,215,1767,666
92818,2141,673,313,151,1828,725
86435,2146,686,292,67,1854,724
81812,2116,765,279,24,1837,773
79032,2098,853,278,42,1820,817
77971,2219,983,316,99,1903,899
77850,2340,1084,356,145,1984,963
79492,2419,1099,363,181,2056,958
84558,2453,1154,342,197,2111,1014
93873,2579,1236,337,193,2242,1100
98678,2642,1328,334,166,2308,1202
98867,2697,1349,345,178,2352,1209
98266,2687,1364,367,212,2320,1203
97735,2513,1259,375,216,2138,1111
96715,2335,1098,387,203,1948,978
95439,2304,1019,440,204,1864,919
94539,2307,969,481,193,1826,908
93662,2337,1007,516,201,1821,972
93619,2385,1064,517,231,1868,1078
94800,2353,1126,529,239,1824,1171
97317,2238,1123,513,253,1725,1168
101746,2218,1321,493,237,1725,1337
102482,2325,1601,545,254,1780,1573
100775,2369,1763,563,252,1806,1711
97118,2316,1800,536,222,1780,1715
91253,2294,1879,542,226,1752,1774
85471,2231,1940,513,199,1718,1818
81320,2195,1973,508,199,1687,1843
78971,2148,1935,513,213,1635,1808
77917,2112,1899,501,207,1611,1767
77973,2109,1881,446,224,1663,1716
80027,2106,1871,402,227,1704,1691
85464,2134,1854,358,239,1776,1643
94829,2184,1806,314,261,1870,1568
99315,2172,1864,287,271,1885,1608
99559,2221,1804,234,258,1987,1560
98655,2164,1719,197,215,1967,1514
98356,2148,1633,161,183,1987,1462
97964,2105,1673,152,197,1953,1489
98003,2073,1722,162,195,1911,1542
97662,2037,1717,180,227,1857,1504
96907,1944,1565,166,209,1778,1368
96561,1836,1447,170,223,1666,1234
97811,1962,1464,189,249,1773,1225
100664,2067,1465,181,231,1886,1246
104705,2164,1528,225,241,1939,1308
105110,2450,1534,299,236,2151,1329
103346,2661,1568,354,219,2307,1389
99572,2673,1608,386,213,2287,1440
93622,2715,1667,444,227,2271,1485
87741,2822,1652,497,214,2325,1492
83547,2408,1049,487,137,1921,965
81211,2343,1111,473,136,1870,1024
80274,2189,1013,426,113,1763,997
80285,2041,907,361,134,1680,937
82158,2011,907,336,146,1675,949
87557,1922,868,332,163,1590,865
96302,1790,727,350,180,1440,733
100570,1788,583,376,196,1412,634
100527,1843,568,366,186,1477,663
100218,1778,561,350,142,1428,644
100112,1804,739,345,83,1459,792
99323,1750,831,331,56,1419,829
98422,1778,900,345,87,1433,856
97905,1914,1136,368,111,1546,1060
97148,1931,1328,414,165,1517,1194
96916,1992,1459,435,198,1557,1276
97779,2024,1488,428,230,1596,1276
100077,2170,1486,437,256,1733,1252
103178,2266,1385,451,257,1815,1150
102585,2192,1209,459,246,1733,978
100874,2310,1157,461,230,1849,944
97904,2495,1132,445,217,2050,955
93278,2594,1119,455,251,2139,960
88118,2618,1022,460,293,2158,841
84028,2512,1005,448,299,2064,834
81602,2537,983,411,287,2126,849
80443,2533,883,407,281,2126,804
80134,2433,736,395,277,2038,672
80869,2312,646,391,286,1921,614
83033,2195,612,403,291,1792,576
86625,2099,499,424,289,1675,488
89837,1876,409,451,303,1425,319
93218,1761,359,472,311,1289,242
95303,1669,274,496,315,1173,276
95544,1602,274,514,331,1088,307
94954,1666,390,513,331,1153,399
93670,1662,356,512,331,1150,395
92021,1736,297,516,325,1220,403
90986,1779,254,529,322,1250,412
90808,1904,439,558,310,1346,542
91915,1971,663,562,292,1409,722
94626,1965,849,559,273,1406,872
98895,1868,886,525,244,1343,884
99980,1868,826,512,208,1356,815
98825,1859,682,501,181,1358,703
96542,1819,653,496,159,1323,661
92830,1804,725,478,96,1326,696
88831,1864,811,436,64,1428,756
85373,1853,890,407,93,1446,822
83512,1851,889,364,142,1487,807
82428,1943,922,355,175,1588,837
82214,2075,904,369,208,1706,840
82758,2127,907,387,228,1740,835
84530,2183,798,400,221,1783,756
86966,2134,753,385,182,1749,740
88779,2081,778,375,158,1706,771
91057,2032,953,390,184,1642,890
92723,1957,1192,398,212,1559,1102
92851,1935,1370,401,224,1534,1262
92281,1908,1476,412,237,1496,1318
91321,1936,1584,411,246,1525,1413
89913,2041,1793,425,257,1616,1595
88745,2076,1826,452,268,1624,1614
88481,2081,1790,453,261,1628,1588
89953,1994,1634,423,223,1571,1487
93312,1918,1426,407,201,1511,1314
99527,1828,1269,420,191,1408,1181
102291,1760,1073,469,182,1291,997
101573,1697,1025,465,188,1232,929
98529,1641,1049,429,195,1212,941
94276,1581,975,413,215,1168,867
89811,1497,881,401,217,1096,774
87141,1437,808,375,229,1062,690
85835,1418,849,374,231,1044,719
85898,1385,848,374,240,1011,689
86665,1443,844,363,252,1080,694
89422,1548,949,368,269,1180,770
95695,1565,973,358,264,1207,783
105142,1601,1116,346,288,1255,896
108882,1567,1193,314,299,1253,969
107756,1518,1089,330,310,1188,829
105630,1504,1069,328,312,1176,788
103759,1440,1105,308,305,1132,827
101669,1436,1136,292,301,1144,875
99468,1462,1155,270,294,1192,906
97636,1483,1168,264,292,1219,950
95369,1539,1148,292,282,1247,928
94193,1615,1163,301,281,1314,962
94739,1638,1215,319,274,1319,1018
97436,1615,1157,321,249,1294,977
104315,1567,1082,328,228,1239,898
106792,1542,1035,349,232,1193,831
105781,1562,918,344,222,1218,728
102116,1607,887,326,196,1281,722
96373,1647,881,312,170,1335,745
90820,1703,783,328,147,1375,655
87011,1717,674,333,148,1384,529
84958,1780,686,298,172,1482,518
84233,1794,663,286,199,1508,486
84374,1792,534,321,245,1471,342
86592,1643,362,277,210,1366,220
92364,1478,298,245,212,1233,166
101336,1355,256,197,201,1158,234
104383,1241,286,171,191,1070,293
102896,1115,298,130,151,985,291
100993,1002,328,110,142,892,364
99260,959,350,107,130,852,414
97983,994,373,114,124,880,443
96613,1077,393,130,113,947,446
95456,1180,283,164,140,1016,346
94115,1406,216,191,159,1215,325
93596,1476,197,225,166,1251,307
94762,1507,282,247,166,1260,310
97807,1559,503,247,139,1312,493
103075,1659,710,275,141,1384,644
104439,1870,953,327,175,1543,853
103169,1972,1126,346,219,1626,992
99548,2003,1251,352,237,1651,1103
94099,2006,1347,376,267,1630,1181
88490,1949,1303,374,261,1575,1144
84562,1910,1300,377,259,1533,1153
82874,1900,1253,368,250,1532,1121
82123,1895,1230,343,222,1552,1098
82029,1839,1115,322,210,1517,998
83975,1894,1040,301,186,1593,944
88805,1946,979,288,185,1658,869
96443,2031,862,264,187,1767,730
100911,2060,780,231,194,1829,639
102950,2160,708,182,190,1978,623
104295,2151,544,171,204,1980,502
105134,2196,518,158,190,2038,593
104909,2249,577,166,174,2083,695
104201,2226,655,167,172,2059,779
103510,2120,740,155,150,1965,847
102660,2042,688,161,149,1881,794
102251,1998,655,164,146,1834,772
102933,2040,675,187,151,1853,792
104812,2149,680,219,157,1930,787
108069,2351,870,268,170,2083,976
108240,2634,1059,332,192,2302,1172
105852,2785,1133,375,194,2410,1235
101632,2833,1104,396,158,2437,1143
95368,2939,1081,433,151,2506,1067
89278,3063,1139,486,183,2577,1096
85272,3120,1209,527,187,2593,1136
83014,3110,1249,536,186,2574,1144
82017,3079,1255,557,178,2522,1147
82143,3038,1158,557,159,2481,1062
83935,3039,1127,576,145,2463,1024
89278,2947,1140,612,151,2335,1049
98067,2927,1269,575,139,2352,1152
101742,3009,1358,535,130,2474,1244
101448,2960,1383,463,128,2497,1275
100519,2877,1402,404,126,2473,1316
99784,2691,1377,377,129,2314,1301
98546,2577,1445,362,155,2215,1351
96869,2534,1455,355,178,2179,1354
96025,2553,1440,365,195,2188,1337
94928,2559,1339,372,209,2187,1244
94067,2540,1300,373,213,2167,1203
95005,2433,1299,369,228,2064,1194
97483,2479,1336,333,209,2146,1255
102212,2541,1324,346,204,2195,1242
104076,2699,1380,379,203,2320,1293
103103,2813,1473,421,212,2392,1367
99646,2881,1437,452,218,2429,1343
93957,2859,1385,455,204,2404,1322
88156,2881,1317,461,179,2420,1278
84180,2858,1215,481,146,2377,1238
82512,2844,1131,508,122,2336,1194
81757,2218,1543,408,236,1810,1479
82194,2765,972,572,136,2193,1100
84234,2746,943,586,141,2160,1073
90031,2746,953,601,140,2145,1077
98992,2715,944,620,157,2095,1081
102856,2873,1104,619,149,2254,1239
102981,2884,1079,580,182,2304,1228
102081,2740,1043,533,211,2207,1195
101291,2720,1141,533,217,2187,1286
99612,2718,1182,556,205,2162,1322
97649,2628,1136,571,173,2057,1260
95856,2576,1100,570,150,2006,1218
93950,2587,1178,566,135,2021,1277
92394,2560,1225,542,139,2018,1316
92181,2495,1194,472,164,2023,1279
93587,2207,998,422,192,1785,1074
97498,1936,905,383,201,1553,964
99410,1938,1005,372,188,1566,1033
98085,2170,1158,404,172,1766,1160
95535,2336,1163,422,120,1914,1131
91292,2416,1111,444,79,1972,1104
86668,2552,1054,494,63,2058,1066
82757,2619,1064,514,67,2105,1102
80602,2822,1236,557,52,2265,1281
79642,2471,1614,428,217,2043,1464
79856,2757,1250,535,64,2222,1253
80703,2787,1270,517,86,2270,1281
83163,2646,1252,501,105,2145,1259
86294,2453,1220,467,129,1986,1206
88562,2316,1192,440,130,1876,1182
89530,2167,1128,422,149,1745,1139
89395,2132,1175,378,175,1754,1163
87945,2164,1173,357,208,1807,1131
85589,2090,1058,336,212,1754,994
82871,2126,922,346,222,1780,845
80149,2151,840,343,225,1808,758
77801,2000,736,299,207,1701,676
76565,1917,769,277,205,1640,738
76539,1900,839,259,199,1641,840
78392,1933,909,250,194,1683,938
83806,1873,951,227,198,1646,978
86363,2002,1005,240,194,1762,1048
85755,2204,1029,270,176,1934,1084
84135,2314,1054,328,180,1986,1076
80922,2394,1136,358,165,2036,1112
77237,2460,1236,413,163,2047,1155
74360,2555,1280,449,215,2106,1123
73742,2606,1292,457,257,2149,1081
72921,1884,1570,326,313,1558,1289
72100,2523,1414,471,291,2052,1136
72602,2475,1369,458,248,2017,1128
73808,2492,1294,440,202,2052,1099
76121,2507,1301,442,184,2065,1124
79041,2479,1210,455,166,2024,1081
80945,2467,1184,456,151,2011,1090
80844,2357,1116,408,153,1949,1045
79937,2273,1014,381,156,1892,986
78773,2127,889,346,141,1781,899
77561,2016,792,336,154,1680,843
76121,1995,811,331,161,1664,869
74750,1909,805,343,153,1566,845
73872,1850,783,349,156,1501,801
73946,1892,941,346,166,1546,892
75290,1875,859,375,193,1500,798
77146,1910,993,391,218,1519,877
82884,2070,1161,447,255,1623,979
85812,2167,1245,462,275,1705,1050
83644,2315,1176,490,287,1825,992
79445,2438,1047,505,278,1933,879
74669,2494,1057,528,279,1966,911
70869,2536,1018,532,283,2004,884
68897,2509,863,519,257,1990,781
68090,1752,1113,428,315,1324,878
68265,2288,760,504,201,1784,748
70168,2254,769,505,183,1749,749
75589,2151,771,541,155,1610,783
85020,2021,690,526,127,1495,700
92068,1940,555,534,105,1406,567
92839,1892,557,514,105,1378,568
92553,1708,581,426,121,1282,562
92355,1390,581,352,117,1038,512
91358,1251,822,285,132,966,718
90313,1267,1052,266,142,1001,934
89619,1335,1121,306,175,1029,983
88455,1510,1130,340,216,1170,977
87818,1727,1173,362,239,1365,996
88019,1825,1247,376,284,1449,1026
88691,2066,1298,355,303,1711,1090
90320,2205,1354,362,337,1843,1144
93892,2315,1294,377,345,1938,1094
94223,2505,1198,397,361,2108,1047
90661,2549,1069,422,378,2127,932
84960,2605,948,423,381,2182,823
78729,2633,857,407,357,2226,766
74098,2732,767,401,337,2331,716
71546,2763,698,413,333,2350,680
70148,2752,591,424,317,2328,591
70058,2830,511,443,312,2387,553
71424,2806,599,448,300,2358,642
76475,2731,735,467,263,2264,735
85767,2727,761,469,221,2258,797
92839,2705,836,467,205,2238,851
93786,2610,888,447,183,2163,854
94125,2466,971,415,178,2051,899
94754,2350,943,344,184,2006,898
94584,2180,960,291,166,1889,928
94233,2086,985,270,128,1816,934
93397,2203,1056,280,134,1923,972
92139,2206,1149,291,161,1915,1024
91098,2144,1207,308,204,1836,1043
91025,2105,1172,345,243,1760,999
91497,2114,1158,365,246,1749,981
92140,2135,1132,364,244,1771,980
95875,2150,978,398,277,1752,882
97522,2233,803,411,287,1822,788
94582,2355,865,390,278,1965,903
89161,2376,922,376,279,2000,959
83338,2399,891,387,283,2012,931
79299,2344,788,369,260,1975,845
77060,2293,692,374,240,1919,768
76315,1896,1091,359,269,1537,1026
76568,2140,562,415,219,1725,680
78594,2120,509,432,231,1688,662
84586,2135,551,429,236,1706,709
94672,2124,465,437,231,1687,641
101192,2120,434,450,240,1670,639
100664,2157,539,454,255,1703,725
98398,2082,699,467,260,1615,841
97050,2038,855,473,243,1565,925
95923,1976,901,444,252,1532,935
95157,1973,968,465,243,1508,931
94507,2016,1072,484,241,1532,984
93452,2108,1215,521,226,1587,1069
92909,2169,1286,551,219,1618,1120
93361,2161,1322,586,202,1575,1152
94156,2113,1286,602,199,1511,1110
95868,2020,1209,588,201,1432,1032
100388,2054,1154,602,183,1452,983
103027,2122,1137,638,172,1484,998
100775,2223,1107,654,160,1569,1015
95300,2408,1013,667,164,1741,980
89503,2468,905,654,181,1814,934
85477,2535,915,660,176,1875,982
83736,2541,870,629,163,1912,916
82634,2540,935,612,191,1928,998
83411,2519,975,592,204,1927,1049
85422,2497,917,554,223,1943,1019
91101,2440,895,521,267,1919,1068
100953,2456,877,513,273,1943,1066
107235,2269,811,497,262,1772,991
106414,2217,899,477,243,1740,1035
104258,2163,948,477,241,1686,1075
102831,2036,955,493,235,1543,1048
100836,2021,1072,503,226,1518,1109
98620,2085,1136,535,248,1550,1128
96951,2137,1146,538,244,1599,1119
94657,2277,1108,552,269,1725,1093
93254,2421,1092,578,277,1843,1097
92625,2571,1090,608,270,1963,1094
92584,2681,1077,623,272,2058,1061
94369,2675,1050,612,281,2063,1009
99533,2504,1007,620,284,1884,935
102606,2474,998,631,289,1843,877
100297,2442,1073,618,290,1824,926
94890,2588,1295,585,323,2003,1043
89152,2675,1343,624,342,2051,1050
84975,2587,1199,589,315,1998,958
82772,2483,1117,561,298,1922,899
81998,2427,1112,586,305,1841,895
82123,2428,1113,584,316,1844,926
84410,2396,994,552,301,1844,868
89541,2240,842,509,308,1731,756
99074,2129,657,496,326,1633,598
105029,2140,506,517,329,1623,411
103907,2049,388,537,358,1512,240
101443,1912,319,536,390,1376,200
99005,1811,321,538,403,1273,376
96323,1760,380,547,396,1213,521
94611,1696,602,535,395,1161,652
92706,1849,784,539,390,1310,806
90592,1988,884,537,380,1451,914
88578,2144,912,534,373,1610,956
87852,2295,939,534,382,1761,999
87670,2397,1002,520,382,1877,1042
88231,2400,1050,507,374,1893,1026
91104,2569,1179,481,331,2088,1109
92205,2827,1323,462,294,2365,1222
89887,2970,1314,420,246,2550,1230
85408,3038,1185,412,231,2626,1090
80288,3120,1048,385,207,2735,963
76266,3196,1091,356,189,2840,1051
73851,3198,1186,340,171,2858,1158
72480,3174,1303,315,153,2859,1266
71892,3162,1389,302,150,2860,1332
72186,3144,1416,290,152,2854,1337
73887,3090,1437,267,134,2823,1358
77243,3018,1497,248,120,2770,1419
81140,2963,1617,234,121,2729,1509
84700,2984,1512,242,121,2742,1405
87353,2952,1438,227,137,2725,1326
88522,2744,1419,218,133,2526,1334
87909,2648,1374,212,132,2436,1314
86478,2533,1307,215,113,2318,1264
85012,2714,1271,226,124,2488,1196
83732,2920,1348,235,157,2685,1223
83072,2936,1452,254,205,2682,1274
83403,2991,1562,251,214,2740,1376
84139,2978,1684,261,233,2717,1488
85165,2824,1659,220,164,2604,1516
87594,2783,1587,219,149,2564,1455
88834,2847,1577,274,207,2573,1385
86701,2792,1475,288,199,2504,1291
83385,2712,1436,298,194,2414,1260
79052,2631,1331,271,189,2360,1161
75683,2615,1349,264,184,2351,1181
73460,2609,1365,271,183,2338,1203
72278,2688,1367,275,205,2413,1193
72078,2768,1386,296,239,2472,1183
72661,2714,1396,291,264,2423,1177
74268,2680,1485,296,268,2384,1284
77057,2587,1622,304,292,2283,1412
80329,2471,1646,287,294,2184,1402
83394,2398,1629,291,294,2107,1365
86277,2236,1555,280,309,1956,1254
87577,2123,1738,303,337,1820,1404
88134,2179,1755,327,352,1852,1412
88331,2183,1663,351,359,1832,1323
87546,2184,1620,368,373,1816,1273
86330,2232,1599,367,360,1865,1300
85528,2299,1653,372,371,1927,1360
86104,2356,1612,383,384,1973,1309
87503,2291,1513,379,379,1912,1210
88915,2214,1217,352,363,1862,940
93349,2045,974,336,341,1709,748
95840,2007,705,366,325,1641,541
93323,2125,580,398,304,1727,543
89153,2127,450,409,262,1718,534
84624,2123,541,430,251,1693,649
81138,2178,688,463,242,1715,774
79301,2276,661,473,250,1803,749
78991,2181,747,471,253,1710,790
79400,2122,697,465,256,1657,735
81558,2050,643,449,258,1601,667
87252,1888,577,446,253,1442,588
96934,1902,621,479,252,1423,605
103421,1892,684,530,230,1362,642
104517,1779,624,535,216,1244,566
104634,1553,510,518,243,1035,443
104909,1504,606,544,289,960,479
104660,1479,653,552,328,927,483
103914,1490,636,543,361,947,542
103272,1385,544,528,368,857,472
102223,1623,545,542,357,1081,550
101684,1933,748,573,349,1360,729
102229,2114,824,559,338,1555,836
103223,2203,821,562,305,1641,862
103733,2098,774,552,286,1546,811
105353,1995,876,530,253,1465,849
104791,1999,945,523,217,1476,859
100589,2210,1017,537,211,1673,888
94457,2244,1028,523,210,1721,907
88224,2203,993,476,213,1728,899
83677,2112,1028,427,237,1685,972
81274,2010,1034,373,248,1637,1002
80162,1997,1044,339,249,1658,1013
79922,1959,1069,315,261,1644,1001
81812,1886,1036,321,259,1565,990
87102,1886,1087,302,254,1584,1020
96836,1963,1113,298,285,1665,987
103066,2096,1193,284,312,1812,1000
103253,2211,1253,262,320,1949,1067
102468,2194,1329,256,322,1938,1139
101196,2180,1391,248,304,1932,1189
99369,2256,1454,231,282,2025,1251
97027,2246,1444,214,249,2032,1245
95305,2175,1450,208,230,1967,1239
93178,2114,1499,203,216,1911,1290
91617,2055,1576,227,234,1828,1350
90847,2025,1508,218,237,1807,1286
91071,2115,1506,248,288,1867,1248
91951,2135,1450,234,271,1901,1213
95975,2108,1309,241,260,1867,1101
99636,2125,1187,261,237,1864,1002
97476,2281,1132,295,237,1986,944
92162,2342,1270,332,248,2010,1077
86547,2268,1336,348,249,1920,1157
82633,2155,1235,363,246,1792,1067
80755,2061,1194,390,249,1671,1033
80036,2036,1153,384,238,1652,1019
80456,1983,1122,404,252,1579,995
82640,1957,1149,414,272,1543,1015
88673,1943,1172,420,285,1523,1060
98771,1934,1238,428,295,1506,1139
104300,1914,1273,443,315,1471,1148
102798,1963,1286,441,309,1522,1170
100518,1956,1356,432,297,1524,1232
99031,1896,1257,423,310,1473,1158
97281,1943,1159,405,315,1538,1125
95572,2035,1135,384,317,1651,1106
94314,2020,1157,346,323,1674,1061
92955,2038,1198,322,327,1716,1073
92040,2152,1130,308,338,1844,1005
92207,2199,1023,287,327,1912,944
92957,2204,937,266,321,1938,926
94452,2157,796,232,302,1925,859
98698,1954,809,210,283,1744,878
101609,1846,754,203,268,1643,817
99172,1908,621,210,266,1698,682
93626,1971,563,205,257,1766,636
87934,2034,402,222,279,1812,486
84030,2155,218,246,277,1909,320
82142,2211,185,245,253,1966,387
81657,2220,384,247,210,1973,468
82180,2248,544,259,169,1989,573
84565,2358,646,302,170,2056,626
90305,2480,710,326,179,2154,662
100413,2470,836,323,171,2147,799
106172,2379,906,326,184,2053,872
106207,2167,848,321,193,1846,788
105443,1808,768,353,189,1455,699
104739,1667,740,369,193,1298,656
103528,1637,514,383,199,1254,433
102100,1732,368,408,212,1324,251
101042,1801,400,409,235,1392,227
99552,1932,492,424,270,1508,292
98325,2087,491,444,302,1643,288
98405,2078,448,465,316,1613,225
99487,2002,519,494,330,1508,265
100824,1907,605,473,354,1434,342
104803,1869,553,437,330,1432,507
107788,1958,709,427,296,1531,738
105283,2131,869,438,267,1693,856
99722,2384,982,432,231,1952,963
93959,2581,1035,440,216,2141,1038
90104,2739,1129,485,235,2254,1149
88044,2843,1181,506,251,2337,1203
87368,2858,1181,535,273,2323,1192
87603,2875,1301,543,288,2332,1283
89596,2795,1352,540,295,2255,1308
94995,2685,1294,529,288,2156,1219
104634,2589,1242,528,282,2061,1174
109671,2490,1176,550,304,1940,1119
108133,2328,1063,495,301,1833,1064
105352,2153,970,431,285,1722,974
103377,2131,1045,422,269,1709,1022
100754,2114,1142,434,290,1680,1080
98669,2129,1133,442,310,1687,1077
96585,2160,1002,453,300,1707,994
94316,2165,818,441,274,1724,842
92038,2058,781,441,260,1617,775
90681,1962,857,424,233,1538,814
89973,1930,932,438,221,1492,860
90173,1877,963,413,205,1464,878
93379,1724,981,356,178,1368,883
96986,1721,951,347,170,1374,860
95603,1832,904,384,174,1448,808
91897,1881,868,365,160,1516,771
87169,1947,952,378,182,1569,821
83449,1885,1055,367,220,1518,865
81268,1915,1065,370,228,1545,862
80324,2091,1168,415,243,1676,961
80257,2158,1235,418,242,1740,1043
81152,2091,1232,414,249,1677,1030
83408,1953,1226,392,245,1561,1028
87173,1839,1247,381,238,1458,1049
90587,1780,1245,386,238,1394,1042
92480,1741,1230,362,226,1379,1048
92524,1715,1246,343,212,1372,1091
91225,1723,1329,308,192,1415,1215
88892,1752,1397,302,168,1450,1318
86406,1541,1105,277,142,1264,1084
83576,1503,991,258,152,1245,1013
80989,1543,1010,253,170,1290,1040
79114,1517,1014,273,199,1244,1042
78250,1582,1008,297,233,1285,1045
78270,1685,883,319,246,1366,916
79317,1825,641,329,257,1496,713
83371,1866,477,321,250,1545,578
87818,1824,498,336,235,1488,577
87164,1854,616,339,234,1515,686
84566,1723,661,318,233,1405,745
80883,1567,555,290,213,1277,643
77802,1623,563,298,198,1325,635
75848,1759,782,294,185,1465,790
75114,1723,795,251,158,1472,815
75266,1601,804,225,142,1376,851
75782,1450,685,204,133,1246,772
77509,1522,772,203,117,1319,832
80377,1592,1086,197,104,1395,1085
82984,1549,1091,190,102,1359,1077
85779,1486,1026,171,102,1315,1021
87374,1380,864,165,98,1215,897
87602,1556,1117,155,102,1401,1111
87212,1813,1379,164,101,1649,1338
87144,1998,1506,184,126,1814,1449
86417,2018,1476,205,165,1813,1409
85750,1941,1371,223,212,1718,1283
86114,2069,1384,230,234,1839,1302
87409,2286,1550,239,245,2047,1450
89210,2387,1631,254,274,2133,1480
91114,2454,1548,260,291,2194,1372
94735,2404,1601,276,299,2128,1402
96329,2461,1698,304,312,2157,1464
93708,2561,1711,338,320,2223,1470
89605,2594,1668,334,270,2260,1483
84994,2590,1661,313,221,2277,1492
81533,2417,1566,323,213,2094,1373
79582,2321,1392,331,220,1990,1201
78893,2217,1304,314,209,1903,1127
79077,2074,1240,327,228,1747,1048
81273,2021,1111,357,256,1664,921
86494,2198,1044,337,261,1861,879
94769,2178,1122,334,294,1844,955
100696,2213,1224,331,296,1882,1028
102678,2308,1353,332,287,1976,1163
103746,2326,1261,330,294,1996,1098
104283,2215,1107,354,305,1861,1009
103944,2129,1065,335,290,1794,1029
103015,2137,1086,316,293,1821,1073
102146,2135,1086,328,331,1807,1094
100941,2131,1124,320,326,1811,1150
100049,2096,1087,279,281,1817,1170
100266,1938,958,267,239,1671,1111
100929,1925,891,276,236,1649,1068
101575,1855,862,289,220,1566,1041
103684,1768,908,307,214,1461,1088
104919,1689,749,288,187,1401,907
101066,1695,525,290,172,1405,674
95254,1748,382,316,137,1432,466
89286,1804,206,338,128,1466,238
85047,1957,115,373,139,1584,100
82641,1993,323,370,138,1623,279
81435,2080,437,407,165,1673,436
81502,2058,531,403,173,1655,529
83425,1963,555,408,196,1555,533
88704,1881,643,402,221,1479,590
97510,1867,645,413,264,1454,577
102491,1907,658,417,278,1490,585
101708,1864,665,424,289,1440,573
99971,1747,833,441,318,1306,675
98213,1703,822,453,333,1250,630
96541,1678,739,470,336,1208,513
95077,1726,745,492,320,1234,504
94198,1789,720,482,312,1307,480
93128,1931,679,490,309,1441,458
92575,2069,727,504,307,1565,494
92370,2130,789,500,313,1630,554
92855,2268,794,520,285,1748,552
93686,2277,839,507,277,1770,607
96838,2310,711,491,229,1819,507
99414,2394,435,504,138,1890,330
96605,2475,508,481,99,1994,429
91428,2434,612,472,54,1962,570
85964,2425,624,456,68,1969,615
81863,2488,631,449,74,2039,623
79704,2503,682,431,92,2072,664
78934,2437,549,392,67,2045,557
79097,2378,599,356,51,2022,630
81135,2229,555,324,45,1905,567
86595,2066,489,292,58,1774,515
95661,1958,362,284,90,1674,390
100272,1948,348,259,133,1689,452
99495,2014,442,234,160,1780,581
98034,2043,640,224,165,1819,768
96787,1800,913,221,168,1579,983
95185,1692,919,196,151,1496,978
93861,1731,889,210,150,1521,928
93133,1899,777,239,159,1660,796
91899,2109,766,264,167,1845,759
90802,2444,832,335,200,2109,785
90733,2648,886,370,219,2278,802
91433,2707,951,406,245,2301,843
92241,2766,1048,438,265,2328,913
95361,2792,1198,458,267,2334,1041
98381,2766,1267,491,254,2275,1104
96020,2773,1229,537,247,2236,1044
90981,2823,1179,579,239,2244,993
85213,2881,1260,584,235,2297,1072
81478,2901,1224,594,196,2307,1066
79449,2980,1288,612,158,2368,1166
78717,3077,1446,618,135,2459,1328
78873,3086,1399,637,97,2449,1307
81040,3086,1385,637,92,2449,1296
86125,3005,1371,619,82,2386,1292
94985,2927,1289,618,64,2309,1240
99432,2808,1200,578,67,2230,1153
98723,2662,1118,588,107,2074,1053
97295,2520,1140,624,146,1896,1036
96139,2503,1137,619,139,1884,1050
94771,2376,1029,613,139,1763,990
93185,2127,936,605,143,1522,924
91961,2028,894,624,164,1404,890
90539,2020,893,672,181,1348,873
89344,2045,923,690,190,1355,898
88800,2056,937,702,188,1354,904
88833,2024,939,700,194,1324,922
89372,1979,970,663,200,1316,962
91568,1853,797,686,207,1167,804
94323,1695,619,665,217,1030,570
92305,1596,519,613,229,983,406
87538,1599,519,578,240,1021,360
81900,1568,609,546,253,1022,430
77704,1535,760,481,262,1054,579
75441,1570,877,478,284,1092,689
74535,1689,1044,483,295,1206,866
74522,1808,1155,487,291,1321,988
76050,1815,1220,501,275,1314,1081
80176,1787,1188,478,260,1309,1085
86536,1770,1099,473,264,1297,1025
90318,1844,1114,470,258,1374,1087
90728,1824,927,474,261,1350,937
89544,1832,993,445,281,1387,1033
87852,1764,916,400,315,1364,988
85695,1808,930,383,328,1425,1007
83689,1801,830,397,310,1404,924
82194,1855,869,417,288,1438,1000
80825,1868,853,433,274,1435,971
79751,1890,940,434,274,1456,1014
79359,1869,914,437,263,1432,966
79304,1879,893,428,246,1451,915
79427,1866,897,400,219,1466,879
81546,1788,908,350,160,1438,881
85139,1822,1005,370,152,1452,927
84077,1939,1135,356,164,1583,1005
81114,1985,1089,328,141,1657,974
77025,1994,1069,295,154,1699,960
73535,2069,1053,271,152,1798,983
71542,2095,1101,255,154,1840,1046
70929,2119,1089,276,218,1843,1032
70943,2162,1180,286,254,1876,1106
72090,2223,1227,307,273,1916,1142
74382,2208,1218,320,292,1888,1129
78180,2206,1145,331,273,1875,1031
81178,2359,1191,367,274,1992,1096
83116,2265,1108,371,282,1894,1004
82785,2145,1043,380,296,1765,981
80926,1920,1027,358,297,1562,984
78924,2077,976,352,319,1725,962
76745,2392,982,363,328,2029,957
74391,2560,1147,392,344,2168,1063
72630,2642,1287,414,348,2228,1133
71512,2745,1261,433,341,2312,1075
71225,2791,1215,467,353,2324,1013
71588,2830,1180,471,338,2359,992
72617,2638,1099,477,318,2161,902
75864,2525,1178,492,296,2033,959
80009,2607,1340,495,282,2112,1087
79153,2942,1482,519,295,2423,1199
76476,3126,1622,500,324,2626,1306
72344,3113,1629,532,302,2581,1346
68647,3204,1666,527,266,2677,1409
66412,3336,1696,557,238,2779,1465
65194,3401,1603,575,173,2826,1435
64837,3315,1627,568,130,2747,1508
65322,3219,1554,544,131,2675,1473
66897,3148,1433,541,148,2607,1354
69510,3088,1309,529,169,2559,1225
72271,2978,1267,476,218,2502,1178
75394,2796,1249,417,203,2379,1163
77483,2366,1193,353,187,2013,1093
77773,2364,1201,340,170,2024,1102
77373,2486,1322,369,169,2117,1218
76909,2668,1392,364,150,2304,1284
75503,2816,1462,363,171,2453,1313
74035,2869,1417,359,179,2510,1243
73037,2969,1514,330,183,2639,1339
72556,3054,1667,352,214,2702,1469
72691,3065,1708,365,214,2700,1504
73513,3080,1739,403,209,2677,1542
76494,3004,1712,404,195,2600,1550
79889,2895,1618,397,207,2498,1457
78810,2828,1473,372,207,2456,1331
75816,2777,1325,382,216,2395,1209
71955,2750,1166,397,242,2353,1094
68922,2562,853,397,248,2165,819
67248,2512,745,392,254,2120,722
66695,2499,666,391,245,2108,659
66954,2510,853,398,227,2112,777
68998,2495,871,366,204,2129,788
74077,2431,853,373,209,2058,761
82119,2499,819,381,208,2118,800
87331,2375,938,369,181,2006,910
89144,2283,909,353,206,1930,933
89533,2172,924,348,255,1824,928
89736,1951,964,313,273,1638,927
89376,1924,982,299,263,1625,915
88492,2043,983,305,269,1738,899
87726,2315,936,314,248,2001,848
86741,2485,942,367,236,2118,876
85637,2715,977,443,282,2272,878
85165,2868,1100,462,302,2406,915
85246,2967,1144,484,308,2483,906
85659,2947,1095,468,305,2479,839
88849,2721,688,400,282,2321,489
93209,2724,266,352,218,2372,344
91551,2770,424,348,221,2422,476
86737,2710,393,334,184,2376,521
81551,2742,517,335,165,2407,672
77802,2807,690,363,126,2444,809
76078,2691,664,378,100,2313,759
75595,2669,714,374,99,2295,792
76195,2742,816,388,104,2354,861
78814,2600,1022,391,107,2209,1004
84508,2422,1039,391,110,2031,1014
93672,2440,1032,406,82,2034,1010
98553,2491,1158,410,97,2081,1118
98179,2542,1374,411,117,2131,1326
96745,2613,1598,426,170,2187,1552
95761,2564,1642,416,181,2148,1576
94405,2424,1420,419,206,2005,1338
93126,2392,1351,428,226,1964,1222
91878,2363,1285,462,252,1901,1111
90274,2282,1040,493,245,1789,855
88497,2353,881,480,243,1873,696
87620,2559,822,508,239,2051,638
87538,2619,996,510,240,2109,862
88407,2686,1196,505,247,2181,1107
92035,2607,1221,439,237,2168,1244
96701,2596,1093,457,242,2139,1141
95307,2515,901,446,221,2069,984
90254,2449,707,460,230,1989,777
85149,2247,485,448,212,1799,566
81361,2166,405,476,239,1690,447
79557,2097,481,520,257,1577,614
79169,2019,619,515,277,1504,815
79653,1861,668,491,281,1370,889
81719,1861,708,456,272,1405,898
87360,1879,713,442,251,1437,838
96332,1864,827,397,236,1467,872
100775,1901,883,379,254,1522,828
99520,1941,1037,367,286,1574,904
97059,2017,1170,364,324,1653,1061
95445,2280,1404,368,323,1912,1275
93699,2214,1448,358,308,1856,1291
92074,2007,1610,355,314,1652,1405
90590,2127,1660,376,302,1751,1471
88980,2297,1534,394,292,1903,1386
87655,2502,1457,412,271,2090,1382
86994,2490,1385,370,287,2120,1332
87190,2397,1294,341,254,2056,1303
87982,2332,1162,282,255,2050,1250
91433,2535,1060,251,240,2284,1219
96466,2744,1087,273,203,2471,1241
95173,2743,1103,296,202,2447,1214
90480,2779,1143,322,190,2457,1257
85311,2690,1181,401,163,2289,1212
81577,2757,1128,406,136,2351,1111
79796,2769,1317,467,181,2302,1219
79526,2506,1367,503,253,2003,1213
79983,2510,1210,541,270,1969,1024
82431,2409,1163,561,304,1848,957
88035,2298,1086,561,324,1737,862
96898,2292,1042,554,331,1738,855
101046,2514,1109,550,351,1964,903
100329,2662,1064,560,352,2102,859
98306,2771,1159,583,339,2188,981
96242,2753,1155,602,317,2151,956
93956,2818,1208,591,312,2227,973
91776,2828,1303,590,294,2238,1038
90200,2929,1365,622,283,2307,1095
88523,2988,1443,640,268,2348,1178
87255,3051,1415,657,252,2394,1165
87403,3104,1407,661,209,2443,1199
88333,3171,1354,660,159,2511,1198
89321,3106,1274,643,112,2463,1168
92043,2846,1195,575,84,2271,1114
95174,2631,1200,531,72,2100,1140
93043,2741,1255,515,66,2226,1204
87701,2823,1268,501,139,2322,1197
82082,2897,1297,480,167,2417,1198
77980,2893,1201,467,192,2426,1072
75831,2887,1154,481,220,2406,971
74705,2833,1166,483,214,2350,997
74664,2792,1137,488,213,2304,980
76451,2672,1064,498,218,2174,923
81344,2508,1019,473,213,2035,941
89624,2402,1035,467,235,1935,933
94238,2278,964,415,227,1863,891
94478,2151,873,367,225,1784,844
92900,1999,593,389,231,1610,595
91185,2028,612,416,245,1612,594
89300,1903,769,427,245,1476,707
87376,1838,805,468,264,1370,726
86122,1927,795,500,283,1427,763
84270,1974,735,515,293,1459,744
82462,1905,638,504,290,1401,683
81273,1884,532,480,285,1404,655
80302,1956,559,466,271,1490,725
79925,2036,656,438,252,1598,828
81679,2102,751,358,221,1744,917
86011,2182,800,323,213,1859,909
85101,2381,883,307,207,2074,1002
81228,2488,860,314,207,2174,1008
76662,2439,849,311,211,2128,1021
72871,2402,899,299,225,2103,1078
70712,2296,737,274,221,2022,916
69933,2237,667,265,211,1972,820
70061,2147,661,272,187,1875,758
71045,2111,684,280,140,1831,746
73535,2164,705,304,123,1860,702
77650,2256,886,322,119,1934,828
80745,2222,1007,306,139,1916,951
83056,2068,1124,243,136,1825,1041
83605,1957,1304,216,152,1741,1202
82974,1977,1479,230,198,1747,1367
81221,2051,1454,261,266,1790,1309
79061,1969,1440,310,305,1659,1319
76789,1962,1468,349,316,1613,1367
74615,2033,1522,373,328,1660,1413
73302,2046,1458,374,333,1672,1334
73021,2055,1324,388,329,1667,1219
73683,2111,1405,377,325,1734,1284
74471,2182,1463,375,327,1807,1297
77133,2189,1534,382,317,1807,1343
81304,2214,1421,439,275,1775,1242
80379,2422,1459,475,272,1947,1235
77051,2503,1460,492,289,2011,1193
72860,2691,1453,488,265,2203,1200
69120,2863,1530,505,270,2358,1284
66841,2820,1596,524,287,2296,1334
65611,2710,1554,519,277,2191,1296
65175,2569,1516,498,282,2071,1251
65382,2525,1462,479,300,2046,1184
66926,2324,1361,481,313,1843,1090
69270,2209,1275,474,320,1735,1045
71228,2183,1342,464,321,1719,1127
73476,2186,1269,459,324,1727,1069
74422,2062,1311,450,313,1612,1164
74105,2034,1271,427,271,1607,1197
73401,2143,1177,439,248,1704,1135
72790,2160,1164,434,232,1726,1147
71686,2103,1105,425,233,1678,1108
70615,1963,935,412,241,1551,1007
70109,2172,988,442,243,1730,1088
70661,2266,991,481,256,1785,1055
71685,2208,980,513,269,1695,1011
72774,2176,878,526,262,1650,866
75544,1967,778,529,251,1438,736
79826,1884,679,541,258,1343,647
78299,1952,430,554,245,1398,415
73701,2052,274,540,231,1512,258
68679,2061,294,500,216,1561,332
64977,1884,336,432,195,1452,301
62953,1925,291,408,202,1517,268
62240,1668,320,361,189,1307,236
62442,1684,390,379,181,1305,299
64172,1784,517,393,186,1391,414
69389,1932,541,417,208,1515,377
78673,1972,540,452,236,1520,358
83838,2026,604,474,244,1552,450
85119,2085,593,478,261,1607,435
85019,2328,705,490,294,1838,746
85467,2605,805,524,283,2081,929
85480,2623,939,525,264,2098,1044
85204,2723,1080,556,253,2167,1169
85155,2766,1062,561,250,2205,1166
84487,2626,1120,559,240,2067,1192
84210,2638,1133,574,222,2064,1191
83917,2746,905,595,222,2151,962
83783,2805,909,550,208,2255,928
83076,2662,910,496,216,2166,900
84473,2341,960,435,212,1906,955
88048,2178,852,398,185,1780,904
85213,2047,808,387,171,1660,900
79016,2241,777,391,188,1850,895
72558,2465,771,408,209,2057,929
67560,2468,819,425,230,2043,996
64442,2413,914,411,213,2002,1095
62990,2242,983,383,200,1859,1107
62425,2226,1002,388,217,1838,1075
63364,2299,945,433,232,1866,963
67763,2170,853,420,225,1750,840
76621,2213,831,410,171,1803,802
81423,2303,866,397,142,1906,814
83422,2136,880,393,161,1743,802
84726,2041,885,386,166,1655,802
86417,2157,904,384,149,1773,811
87180,2331,951,401,151,1930,889
88009,2536,957,435,165,2101,929
88433,2749,916,502,181,2247,958
88597,2853,898,552,196,2301,960
88764,2862,825,595,213,2267,905
89350,2839,762,611,238,2228,850
89382,2938,777,589,269,2349,860
88661,3031,882,607,274,2424,907
89397,2774,967,522,252,2252,965
93105,2819,1001,541,260,2278,918
90186,3033,815,526,256,2507,735
83251,3218,808,584,256,2634,682
75891,3331,817,607,259,2724,706
70437,3288,778,580,272,2708,644
67061,3201,722,532,261,2669,594
65071,3193,665,487,227,2706,578
64156,3200,800,470,190,2730,750
64787,3151,881,504,188,2647,810
69295,3233,889,495,164,2738,813
77716,3450,806,463,164,2987,710
82902,3589,661,433,191,3156,566
85728,3595,511,389,215,3206,430
87771,3635,398,369,199,3266,414
90117,3425,688,413,234,3012,684
92008,3369,835,441,237,2928,871
93403,3308,852,457,237,2851,882
94946,3181,1030,447,223,2734,1020
95887,3310,1051,472,236,2838,969
96481,3326,1010,500,256,2826,892
97019,3337,966,512,238,2825,880
97040,3511,865,509,201,3002,805
95898,3426,776,503,154,2923,750
95995,3160,821,512,171,2648,775
97226,3007,852,550,145,2457,782
93221,2851,697,551,151,2300,600
85929,2753,670,585,155,2168,586
78801,2578,602,575,217,2003,557
73251,2363,535,530,248,1833,500
69605,2151,563,508,236,1643,499
67239,2122,655,538,221,1584,599
66088,2116,567,562,226,1554,528
66679,2002,449,493,253,1509,415
70812,2003,588,435,280,1568,553
79039,1918,652,420,295,1498,584
84273,1858,762,416,312,1442,660
86743,1743,959,414,324,1329,794
88616,1660,1076,459,331,1201,892
90730,1637,1077,465,308,1172,902
91990,1752,1036,478,281,1274,889
92830,1847,1145,482,237,1365,1025
93831,1887,1252,476,218,1411,1157
93925,1907,1164,441,225,1466,1108
93632,1826,1184,410,220,1416,1123
93207,1797,1162,386,195,1411,1129
92615,1761,1103,387,144,1374,1112
91404,1676,1116,364,118,1312,1109
91627,1571,1138,325,105,1246,1102
93013,1572,1037,331,154,1241,937
89057,1802,956,377,207,1425,806
82491,1936,737,399,217,1537,567
75415,2170,608,388,229,1782,483
70460,2414,736,406,236,2008,640
67142,2348,764,418,247,1930,705
65568,1972,622,404,253,1568,621
64872,1723,565,399,245,1324,612
65771,1656,518,416,230,1240,563
70212,1777,634,431,235,1346,714
78792,1829,723,403,228,1426,807
84613,1925,786,341,229,1584,858
86744,1996,920,282,245,1714,955
87906,1807,953,235,228,1572,929
89010,1994,1033,254,241,1740,1010
89454,2088,1114,262,227,1826,1127
89228,2100,1236,271,225,1829,1227
89096,2174,1327,302,236,1872,1303
88627,2219,1462,304,231,1915,1419
87925,2188,1564,282,202,1906,1534
87852,2153,1596,285,199,1868,1576
87770,2059,1512,264,172,1795,1524
86839,1953,1432,248,132,1705,1442
86766,1849,1334,256,105,1593,1307
88024,1878,1323,296,127,1582,1223
85609,1969,1316,316,137,1653,1181
80698,2103,1289,346,186,1757,1106
74933,2219,1241,364,224,1855,1027
70032,2371,1250,375,241,1996,1022
66844,2492,1179,372,242,2120,951
65088,2635,1278,371,247,2264,1039
64208,2648,1301,401,253,2247,1069
64317,2529,1253,395,250,2134,1054
65926,2399,1062,353,209,2046,913
68687,2352,843,321,193,2031,718
71717,2311,649,267,181,2044,516
75251,2243,650,227,157,2016,571
77708,2138,925,235,188,1903,818
78757,2458,1021,235,216,2223,902
78650,2518,939,225,193,2293,807
77648,2469,939,224,187,2245,785
76310,2360,951,237,185,2123,786
75248,2225,979,277,219,1948,788
74466,2249,963,288,227,1961,760
74533,2273,967,312,242,1961,754
74627,2261,905,314,226,1947,724
74667,2264,873,295,214,1969,754
75655,2072,773,290,208,1782,687
79114,1980,910,314,226,1666,819
78467,2141,1061,345,244,1796,943
74923,2260,1102,370,250,1890,1011
70160,2303,1055,368,236,1935,979
66437,2403,1184,361,227,2042,1088
63914,2320,1168,346,225,1974,1041
62646,2182,1162,304,203,1878,1025
62012,2223,1120,290,204,1933,982
62243,2214,1118,296,214,1918,952
63542,2197,1134,286,211,1911,942
65380,2027,1054,291,207,1736,855
67516,1995,1037,253,197,1742,841
70620,1843,989,206,195,1637,803
72523,1723,1167,199,202,1524,975
73119,1592,1212,222,211,1370,1005
72923,1595,1143,239,219,1356,930
72506,1701,1051,264,217,1437,844
71759,1782,1056,255,224,1527,853
70917,1870,1043,251,243,1619,833
70697,1927,987,222,235,1705,814
71163,1916,1018,202,239,1714,884
72123,1884,1204,145,195,1739,1108
73028,1782,1234,128,183,1654,1162
75612,1776,1150,150,177,1626,1119
80265,1914,1127,189,152,1725,1120
78678,2231,1057,237,151,1994,1062
73901,2497,943,258,151,2239,944
68756,2678,910,275,137,2403,898
64892,2893,814,332,132,2561,807
62640,2993,677,384,144,2609,672
61575,2950,544,403,184,2547,559
61275,2909,711,413,188,2496,692
62693,2894,726,431,197,2463,714
67414,2804,537,433,184,2371,593
76493,2747,480,437,164,2310,563
81668,2802,509,403,145,2399,593
83610,2743,576,355,176,2388,630
84413,2584,745,387,238,2197,712
84843,2558,851,395,226,2163,831
84794,2587,917,380,239,2207,883
84362,2540,990,356,240,2184,935
83915,2514,934,387,281,2127,874
83431,2463,946,399,295,2064,870
82679,2430,966,391,298,2039,879
82269,2310,851,366,296,1944,798
82581,2260,810,371,298,1889,795
82856,2185,725,371,315,1814,784
84199,2144,613,380,327,1764,779
87035,2177,479,413,332,1764,728
84523,2296,509,438,320,1858,797
78220,2474,584,465,320,2009,859
71825,2546,540,467,308,2079,817
66961,2717,508,476,295,2241,721
64362,2830,519,476,280,2354,691
63036,2708,509,461,254,2247,617
62667,2605,487,452,227,2153,573
63762,2491,615,458,205,2033,671
68440,2373,685,479,214,1894,730
77012,2142,837,479,213,1663,887
81703,2058,955,460,227,1598,993
83239,1914,995,436,242,1478,1032
83859,1724,1114,403,226,1321,1090
84733,1614,1109,370,208,1244,1072
85142,1638,1121,331,198,1307,1108
85278,1602,1041,299,192,1303,1057
85664,1564,872,273,179,1291,886
85629,1630,937,286,196,1344,930
85650,1718,947,311,232,1407,956
85785,1744,956,330,250,1414,971
85612,1781,981,341,263,1440,982
85144,1772,963,317,263,1455,978
85718,1707,863,305,259,1402,904
88812,1631,665,314,251,1317,741
85976,1814,630,363,237,1451,770
79257,2064,562,424,222,1640,714
72666,1977,514,401,203,1576,642
67659,1864,677,379,209,1485,736
64872,1764,759,366,209,1398,783
63287,1636,774,352,217,1284,771
62610,1565,687,362,228,1203,673
63832,1578,703,363,219,1215,687
68366,1394,703,370,244,1024,610
76719,1403,888,354,241,1049,752
81738,1358,955,295,222,1063,809
83776,1243,959,250,213,993,845
85010,1084,943,214,204,870,853
86077,1082,1059,176,171,906,1006
86925,1016,1029,145,147,871,992
86967,997,998,137,132,860,976
87530,1046,950,175,152,871,937
87752,1044,853,176,154,868,840
87631,1092,824,175,148,917,829
87918,1080,810,178,154,902,824
87754,1045,746,195,169,850,760
86993,1064,782,201,187,863,804
86856,1115,896,211,193,904,906
89666,1186,1013,250,215,936,986
87105,1111,810,272,219,839,742
80383,1175,770,301,189,874,690
73567,1271,911,318,176,953,807
68441,1346,1006,327,211,1019,846
65287,1265,852,320,244,945,645
63646,1263,916,314,256,949,691
62977,1328,1036,319,265,1009,805
64099,1336,1172,312,274,1024,938
68644,1270,1174,297,268,973,948
76801,1222,1175,274,251,948,977
82114,1147,1217,239,230,908,1029
84100,941,1118,189,223,752,914
85498,712,928,149,222,563,716
86979,797,1000,145,206,652,806
87843,1005,1094,193,224,812,892
88613,1174,1139,224,225,950,945
89156,1369,1223,253,243,1116,1025
89456,1434,1200,260,227,1174,1030
89419,1502,1164,277,236,1225,985
89435,1521,1032,288,230,1233,866
88959,1591,1026,310,247,1281,842
87951,1659,981,309,252,1350,778
87843,1807,1147,306,260,1501,918
90607,2002,1143,322,250,1680,925
88346,2181,962,322,250,1859,774
81428,2388,854,324,246,2064,689
74752,2473,852,322,230,2151,674
69378,2445,856,332,248,2113,659
66224,2491,958,346,236,2145,783
64493,2512,1130,373,248,2139,959
63811,2579,1206,395,252,2184,1037
64571,2511,1286,406,251,2105,1106
68928,2560,1235,422,245,2138,1061
76707,2653,1222,428,262,2225,1039
82198,2649,1267,426,282,2223,1072
84559,2512,1329,394,296,2118,1094
86439,2382,1473,390,298,1992,1218
87824,2310,1496,409,298,1901,1255
88496,2327,1395,432,301,1895,1178
88742,2345,1261,438,292,1907,1059
89074,2337,1268,430,283,1907,1059
88491,2381,1255,433,290,1948,1040
88042,2449,1196,437,281,2012,987
87826,2545,1231,468,320,2077,970
87584,2630,1251,480,345,2150,965
86572,2683,1212,472,357,2211,925
86410,2580,1165,467,353,2113,888
87408,2492,1019,472,325,2020,807
84915,2539,787,451,299,2088,634
80001,2668,655,445,292,2223,584
74083,2787,674,458,307,2329,576
69141,2845,589,468,304,2377,453
66113,2950,528,482,296,2468,368
64419,2861,523,459,263,2402,403
63598,2843,538,433,260,2410,392
63761,2793,627,474,311,2319,400
65231,2913,729,470,286,2443,551
68017,2883,754,469,244,2414,644
70950,2778,785,442,204,2336,742
74698,2490,872,402,230,2088,831
77276,2356,1009,383,241,1973,947
78297,2278,1060,356,251,1922,998
77832,2228,944,311,241,1917,931
76708,2127,956,288,246,1839,931
75187,2099,1045,287,239,1812,979
73811,2084,1062,287,243,1797,1002
72803,2104,1110,298,266,1806,1056
72385,1978,1162,306,266,1672,1092
72683,1951,1122,302,243,1649,1075
73046,2006,1085,306,222,1700,1071
74005,2015,1102,348,200,1667,1051
78312,1966,985,361,151,1605,942
78425,1979,885,376,101,1603,862
75316,2066,907,363,93,1703,847
71365,2122,809,349,90,1773,737
67845,2015,723,348,113,1667,649
65749,2021,812,333,99,1688,765
64849,2099,937,345,125,1754,838
64692,2050,997,325,101,1725,947
65200,1930,990,329,105,1601,931
66739,1932,990,331,103,1601,965
68357,1977,1018,359,132,1618,982
70568,1965,1023,317,141,1648,943
73430,1845,1067,259,155,1586,959
74760,1827,1317,267,253,1560,1086
74515,1857,1371,249,256,1608,1133
73871,1886,1403,225,258,1661,1166
73005,1879,1359,191,233,1688,1141
71919,1885,1298,183,220,1702,1096
70776,1877,1303,198,213,1679,1119
70157,1919,1327,215,215,1704,1163
70543,2073,1305,243,238,1830,1143
71570,2099,1278,253,221,1846,1141
72697,1981,1321,220,177,1761,1189
74953,1880,1176,210,101,1670,1134
80206,1751,1018,238,75,1513,1005
79861,1700,942,268,55,1432,929
76034,1774,891,297,62,1477,873
71603,1867,921,281,50,1586,888
68503,1810,866,285,88,1525,797
66898,1928,923,315,105,1613,856
66358,1883,949,300,110,1583,852
66864,1909,991,336,132,1573,867
68954,1886,1016,324,132,1562,891
74827,2006,1049,329,143,1677,927
83860,2017,1128,305,158,1712,1013
88260,2038,1047,294,166,1744,923
88257,2018,1054,262,175,1756,938
87621,2096,1153,269,220,1827,1077
87286,1990,1157,257,195,1733,1076
86429,2000,1049,214,145,1786,982
85747,2016,993,201,140,1815,933
84910,2109,1116,255,176,1854,1023
83861,2205,1145,251,165,1954,1061
82910,2332,1125,265,165,2067,1026
82476,2548,1161,309,187,2239,1022
82428,2737,1159,341,230,2396,960
82503,2817,1066,356,198,2461,900
83611,2685,866,359,178,2326,731
87460,2414,572,402,201,2012,418
86138,2370,492,483,251,1887,279
80160,2372,518,518,260,1854,313
73937,2373,585,529,249,1844,381
69626,2466,597,525,224,1941,406
67282,2510,585,521,196,1989,411
66133,2488,610,527,179,1961,470
66139,2428,690,505,190,1923,560
67750,2400,826,488,210,1912,709
72995,2290,851,518,221,1772,734
81638,2231,766,528,232,1703,681
86088,2185,682,522,255,1663,632
87180,1880,525,497,256,1383,490
87132,1743,510,500,256,1243,428
87002,1735,650,504,286,1231,545
86378,1942,890,503,295,1439,801
86029,2133,956,521,299,1612,900
85657,2184,886,529,295,1655,893
84999,2215,878,548,314,1667,889
84203,2192,916,542,299,1650,897
83803,2239,935,566,303,1673,915
83692,2270,947,567,297,1703,936
83437,2261,891,572,265,1689,870
84477,2220,742,559,255,1661,722
88099,2071,473,539,207,1532,490
86042,2110,527,532,176,1578,559
80076,2078,546,552,186,1526,557
73520,2013,442,572,199,1441,484
69093,2082,443,569,204,1513,480
66771,2141,428,559,199,1582,491
65442,2108,516,524,187,1584,539
65483,1960,564,478,186,1482,559
66945,1815,558,459,194,1356,511
71812,1772,558,466,217,1306,498
80146,1832,561,456,219,1376,498
84550,1891,625,443,227,1448,560
85471,1873,628,416,244,1457,566
85699,1858,760,411,253,1447,729
86019,1930,657,415,267,1515,628
85815,2020,590,407,274,1613,570
85654,2017,593,418,276,1599,570
85657,2001,653,433,286,1568,604
85465,1998,635,455,278,1543,601
85139,2069,600,468,267,1601,572
85189,2123,666,464,266,1659,591
85206,2141,724,441,294,1700,551
84593,2118,733,415,337,1703,485
85260,1950,713,355,302,1595,543
88118,1868,708,330,302,1538,536
86548,1912,654,342,302,1570,515
80739,2167,725,357,310,1810,573
74427,2301,814,368,320,1933,637
69704,2330,847,379,291,1951,648
67192,2263,887,375,270,1888,692
65925,2194,944,343,238,1851,787
65707,2328,966,346,259,1982,825
67159,2473,940,339,258,2134,833
72223,2428,939,336,234,2092,851
80396,2443,944,305,192,2138,915
84877,2477,880,271,180,2206,873
85889,2411,858,230,202,2181,794
85775,2373,890,196,206,2177,870
85772,2504,751,172,210,2332,805
85370,2582,567,183,208,2399,702
84598,2597,519,200,173,2397,642
84202,2618,434,210,162,2408,539
83566,2695,382,214,168,2481,474
82922,2742,498,255,223,2487,535
82563,2609,706,267,216,2342,702
82262,2560,836,239,176,2321,829
81466,2507,891,225,158,2282,903
82072,2275,828,188,155,2087,850
85620,1937,833,182,173,1755,864
85138,1837,871,258,257,1579,880
79766,1861,940,310,291,1551,930
73931,1909,1042,321,276,1588,984
69488,1834,1067,315,216,1519,956
67277,1716,933,305,205,1411,820
66457,1734,847,315,200,1419,760
66554,1870,632,348,205,1522,550
68195,1920,345,382,227,1538,317
73364,1926,261,366,218,1560,273
81612,2054,229,374,235,1680,232
85765,1999,144,332,231,1667,210
85882,1694,220,286,213,1408,246
85074,1717,456,279,224,1438,394
84660,1836,477,285,250,1551,451
83977,1883,396,300,273,1583,457
83036,1845,381,292,259,1553,484
82546,1849,344,293,253,1556,470
81655,1838,390,315,236,1523,427
80854,1970,409,333,223,1637,380
80049,2207,393,345,225,1862,289
79286,2554,690,335,225,2219,476
78023,2728,930,375,274,2353,669
77679,2711,970,394,269,2317,735
80591,2500,955,370,253,2130,756
80278,2443,1046,346,229,2097,846
76059,2359,1045,344,237,2015,842
70667,2203,943,306,245,1897,757
66012,2238,921,280,246,1958,787
63388,2144,932,257,238,1887,860
62178,1943,850,236,206,1707,808
61712,1953,905,244,212,1709,877
62393,2069,995,265,227,1804,973
64399,2103,978,264,228,1839,938
66880,1924,990,261,232,1663,892
69652,1858,1048,251,239,1607,975
72508,1917,1131,248,251,1669,1088
74119,2048,1186,238,240,1810,1156
74531,2152,1081,243,242,1909,1062
73964,2376,919,253,249,2123,910
73087,2448,793,259,246,2189,819
72257,2349,799,243,220,2106,847
71522,2257,813,259,225,1998,852
71260,2424,756,277,239,2147,786
71608,2492,809,292,255,2200,825
72034,2452,788,299,267,2153,770
71953,2540,757,285,254,2255,707
72291,2513,744,269,237,2244,722
75488,2403,770,275,227,2128,817
74837,2360,807,306,198,2054,892
70998,2402,919,303,171,2099,1013
66389,2393,978,325,168,2068,1053
62259,2306,1069,328,154,1978,1116
59830,2234,1155,324,139,1910,1173
58244,2092,1168,321,135,1771,1161
57628,2084,1205,339,136,1745,1196
57781,2137,1182,359,121,1778,1215
58875,2101,1150,350,119,1751,1181
60284,2030,1085,324,114,1706,1102
62506,1866,1065,312,119,1554,1076
65897,1734,1083,293,129,1441,1092
68787,1705,1089,304,129,1401,1121
70270,1780,1171,321,146,1459,1232
71244,1769,1166,324,173,1445,1253
71780,1766,1147,351,212,1415,1262
71446,1706,1068,358,224,1348,1195
71223,1724,1089,341,254,1383,1226
71133,1738,1187,359,257,1379,1289
71901,1664,1113,350,257,1314,1209
73049,1655,1168,349,244,1306,1214
73889,1719,1073,350,259,1369,1130
75580,1524,756,339,235,1185,800
78287,1351,648,322,221,1029,644
76895,1398,778,354,249,1044,729
72199,1476,798,347,267,1129,709
67290,1403,706,354,283,1049,559
63810,1340,732,384,307,956,539
61484,1381,818,400,302,981,652
60505,1366,854,379,299,987,716
60481,1296,814,381,320,915,645
61997,1242,766,390,340,852,563
66726,1204,785,377,330,827,544
75323,1178,775,356,315,822,526
80499,1200,820,343,320,857,582
83182,1113,833,322,316,791,613
84807,1058,901,299,319,759,664
86107,1213,1140,300,317,913,876
86603,1385,1283,330,310,1055,1001
86575,1529,1316,337,299,1192,1044
86304,1691,1443,338,296,1353,1167
85653,1838,1552,333,308,1505,1251
84891,1891,1562,347,333,1544,1237
84638,1911,1523,347,339,1564,1201
84760,1951,1386,349,332,1602,1085
84428,1998,1225,344,315,1654,940
84580,1912,1134,324,307,1588,875
86381,1797,903,320,313,1477,678
84455,1911,725,318,314,1593,588
78235,1972,633,326,317,1646,549
71596,1994,665,344,328,1650,520
66878,2017,810,353,331,1664,607
64167,1952,809,349,326,1603,614
62847,1988,838,340,331,1648,624
62643,2065,745,339,330,1726,598
63714,2000,732,355,320,1645,645
68235,2052,675,356,319,1696,600
76247,2114,607,361,318,1753,571
81175,2128,610,351,327,1777,587
83057,2072,687,346,321,1726,717
84115,2106,719,333,321,1773,741
85169,2079,790,298,326,1781,796
85482,2103,746,266,329,1837,758
85676,2124,733,261,328,1863,750
85744,2171,665,253,319,1918,714
85618,2196,685,243,305,1953,709
85515,2290,653,261,301,2029,626
85728,2358,631,283,274,2075,659
85646,2369,701,301,250,2068,720
84905,2409,660,357,254,2052,730
84991,2239,680,389,233,1850,782
87498,1945,732,387,172,1558,771
86408,1853,823,363,142,1490,802
80235,1976,999,416,163,1560,928
73515,2094,1070,430,182,1664,1001
68396,2020,1045,409,200,1611,971
65063,1886,964,372,184,1514,915
63548,1660,834,315,182,1345,799
62949,1639,818,313,167,1326,786
64102,1599,781,332,190,1267,770
68704,1549,682,332,201,1217,658
76164,1504,618,310,198,1194,663
80794,1460,601,304,202,1156,653
82613,1345,776,276,203,1069,771
83888,1220,948,223,178,997,929
85474,1286,1056,221,144,1065,1017
86315,1339,1027,217,117,1122,997
86931,1428,1103,227,118,1201,1059
87641,1459,1167,237,95,1222,1110
87795,1520,1205,248,102,1272,1121
87890,1621,1188,254,110,1367,1095
87939,1591,1155,235,109,1356,1059
87873,1507,1009,201,91,1306,930
87024,1479,1021,198,120,1281,919
86285,1379,943,182,102,1197,858
88686,1286,831,164,99,1122,751
87758,1286,819,189,136,1097,714
81320,1317,837,210,164,1107,703
74204,1327,829,221,161,1106,701
68580,1281,860,250,145,1031,742
65260,1265,810,290,133,975,716
63400,1313,697,296,139,1017,605
62584,1333,589,261,95,1072,521
63590,1373,571,223,58,1150,532
68100,1462,612,224,35,1238,603
75151,1533,747,256,59,1277,726
80272,1380,712,225,82,1155,668
82105,1275,629,233,153,1042,555
83359,1225,660,249,181,976,529
84103,1252,703,244,189,1008,557
84662,1308,701,244,171,1064,592
85211,1371,688,244,148,1127,612
85752,1334,680,225,110,1109,632
85745,1327,583,206,85,1121,556
85431,1365,545,216,86,1149,519
85256,1442,581,222,75,1220,547
85005,1517,546,224,62,1293,506
83935,1504,463,230,64,1274,426
83427,1381,432,204,89,1177,373
86374,1255,567,205,113,1050,487
85341,1283,625,211,131,1072,559
78961,1444,720,218,140,1226,644
72235,1597,816,208,134,1389,741
66971,1680,919,188,109,1492,849
64031,1690,940,174,111,1516,874
62515,1763,1014,152,113,1611,948
62084,1820,1068,144,126,1676,1014
63094,1796,1042,161,141,1635,1001
67603,1868,1045,183,166,1685,1002
74902,1906,891,190,199,1716,856
79965,1831,751,201,198,1630,703
82315,1734,714,190,181,1544,651
83425,1700,871,177,177,1523,791
84290,1787,971,175,158,1612,867
84575,1951,1011,183,145,1768,910
84504,2047,1014,179,132,1868,913
84674,2064,967,172,122,1892,877
84174,2057,886,162,102,1895,821
83604,2209,871,167,104,2042,805
83040,2259,885,184,136,2075,784
82084,2269,787,172,123,2097,700
80562,2214,789,188,145,2026,676
79608,2015,838,192,183,1823,668
82046,1884,730,194,188,1690,559
81680,2054,689,227,208,1827,557
76994,2328,704,269,219,2059,612
71044,2688,612,316,232,2372,531
66191,2756,543,309,215,2447,514
62972,2658,625,296,211,2362,645
61603,2526,498,256,172,2270,592
60800,2334,266,247,162,2087,354
60769,1871,317,233,152,1638,237
62332,1720,440,230,154,1490,357
64202,1891,410,213,135,1678,362
67127,1973,387,178,130,1795,352
70611,1906,368,165,139,1741,386
73031,1876,636,180,139,1696,674
74106,1952,792,228,129,1724,858
73993,1880,959,275,151,1605,1026
73542,1687,1000,308,212,1379,1053
72850,1704,1121,306,220,1398,1182
72322,1700,1103,279,193,1421,1164
71987,1687,1025,287,212,1400,1085
72378,1647,950,290,222,1357,995
72543,1612,962,291,213,1321,980
72424,1489,787,281,195,1208,798
72597,1462,636,302,230,1160,554
75441,1329,660,298,229,1031,470
75772,1478,815,306,223,1172,606
71983,1718,742,322,242,1396,577
67125,1780,703,311,267,1469,558
62834,1718,742,287,275,1431,594
60124,1718,801,267,262,1451,631
58529,1598,805,247,243,1351,683
57863,1529,911,225,230,1304,811
57760,1569,964,199,195,1370,869
58977,1434,875,182,190,1252,792
59761,1473,932,167,169,1306,818
62016,1362,876,151,142,1211,772
65790,1273,793,149,120,1124,716
68615,1188,796,163,131,1025,722
69739,1139,806,161,121,978,734
70232,1104,747,137,112,967,682
70378,1144,694,135,126,1009,615
70202,1315,749,155,143,1160,641
69774,1465,838,171,141,1294,726
69958,1549,854,179,117,1370,764
70831,1493,794,171,102,1322,711
71959,1515,751,163,104,1352,658
72741,1450,580,160,110,1290,484
73604,1457,467,162,127,1295,376
77204,1410,411,186,163,1224,343
77049,1525,472,196,197,1329,455
72284,1557,502,182,190,1375,498
67161,1418,543,171,188,1247,514
63329,1337,566,172,200,1165,546
61114,1314,629,165,186,1149,627
60152,1314,650,171,186,1143,625
60074,1346,708,177,187,1169,651
61557,1397,766,174,179,1223,720
66240,1384,775,182,188,1202,749
74022,1376,684,182,196,1194,680
79586,1313,635,158,162,1155,618
82195,1166,551,133,131,1033,540
83560,1113,662,132,139,981,679
84574,1221,824,149,166,1072,849
85249,1300,881,175,175,1125,867
85354,1316,878,190,171,1126,836
85573,1363,899,178,166,1185,835
85232,1447,818,162,126,1285,758
84969,1638,721,171,119,1467,654
84746,1771,706,172,111,1599,635
84647,1745,808,178,124,1567,737
84187,1885,860,188,124,1697,802
84057,1772,861,173,107,1599,826
86025,1557,705,176,84,1381,692
84691,1798,798,201,92,1597,810
78449,1993,910,210,104,1783,947
71775,2063,946,205,94,1858,983
67020,2044,944,200,100,1844,967
64220,2071,1000,198,110,1873,1014
62531,2074,1132,196,129,1878,1140
62004,2015,1193,201,114,1814,1193
63305,1930,1128,195,126,1735,1127
67504,1876,993,188,150,1688,1000
74948,1734,930,182,159,1552,937
80220,1636,1041,167,161,1469,1062
82698,1497,1073,146,149,1351,1102
84239,1249,982,85,84,1164,1021
85799,1242,927,127,118,1115,982
86560,1265,675,132,114,1133,753
86894,1279,466,134,115,1145,554
87465,1432,548,150,129,1282,659
87192,1443,622,154,117,1289,727
86930,1400,574,171,128,1229,692
86509,1443,562,180,150,1263,704
86036,1571,648,212,174,1359,814
85222,1603,570,230,195,1373,752
85168,1683,615,264,184,1419,743
86929,1585,571,308,163,1277,642
85361,1587,619,350,151,1237,655
79303,1630,727,376,141,1254,745
72564,1745,743,405,137,1340,795
67585,1760,711,427,115,1333,765
64659,1677,674,414,111,1263,737
62935,1632,745,373,102,1259,772
62351,1518,761,348,111,1170,760
63231,1503,791,336,126,1167,761
67746,1491,840,314,143,1177,827
75352,1459,889,317,172,1142,859
80465,1370,845,274,192,1096,856
82985,1195,690,265,229,930,687
84732,1139,654,272,265,867,616
86194,1152,632,280,299,872,581
87120,1248,748,270,280,978,662
87502,1329,845,274,278,1055,743
87879,1280,806,260,286,1020,695
87657,1287,781,253,282,1034,698
87172,1413,805,239,271,1174,771
86993,1528,861,216,249,1312,861
86755,1458,976,195,227,1263,987
85727,1463,1005,196,222,1267,1013
84951,1342,959,206,187,1136,965
86810,1155,891,204,123,951,900
85512,1185,924,203,133,982,927
79636,1357,1018,227,128,1130,1006
72862,1403,941,234,111,1169,917
67725,1377,754,259,122,1118,720
64710,1446,816,283,140,1163,756
62942,1537,906,304,158,1233,822
62382,1613,836,293,148,1320,743
63372,1651,772,271,135,1380,676
67636,1717,793,247,100,1470,716
74734,1588,791,197,54,1391,757
80274,1686,875,180,53,1506,868
82973,1491,968,116,27,1375,985
84718,1453,1072,115,26,1338,1092
86280,1562,1120,129,54,1433,1142
87061,1700,1027,151,59,1549,1030
87599,1836,1038,150,56,1686,1015
88572,1890,1010,160,54,1730,999
88910,1964,1030,180,83,1784,1020
88724,2009,1007,190,81,1819,1016
88627,2063,910,209,105,1854,892
88279,1880,861,228,119,1652,834
87056,1920,817,224,118,1696,790
86414,1890,790,220,137,1670,752
88327,1791,684,240,168,1551,625
87177,1679,529,268,174,1411,453
80586,1523,484,298,168,1225,421
73610,1511,569,305,193,1206,518
68120,1605,641,305,186,1300,670
64896,1638,673,297,190,1341,721
62979,1573,617,285,166,1288,716
62220,1524,612,311,145,1213,714
62878,1554,694,317,131,1237,770
66847,1431,542,317,139,1114,602
73775,1327,485,294,142,1033,561
79664,1357,593,291,146,1066,635
82831,1266,518,281,157,985,547
85290,1092,357,262,175,830,369
87404,1042,373,244,188,798,364
88953,1086,379,246,175,840,382
90115,1118,332,268,186,850,353
91300,998,320,270,186,728,338
91400,977,249,278,181,699,243
90921,1081,213,273,160,808,288
90394,1146,196,268,162,878,295
89131,1132,287,288,177,844,302
87012,1115,424,313,142,802,375
85685,1087,423,325,138,762,338
86964,1130,315,316,104,814,274
85658,1185,263,335,111,850,192
80444,1181,353,309,102,872,263
74166,1438,648,300,94,1138,570
68640,1492,721,308,97,1184,647
65065,1532,862,309,111,1223,811
62706,1454,854,298,98,1156,820
61399,1452,853,274,95,1178,814
61185,1414,759,253,93,1161,712
62123,1377,717,259,98,1118,654
63929,1327,742,241,95,1086,683
67023,1308,827,201,95,1107,799
71866,1136,700,158,94,978,676
75867,1011,635,141,87,870,603
78336,1108,615,166,105,942,574
79482,1287,681,198,151,1089,630
79664,1441,737,202,147,1239,679
79077,1648,866,212,139,1436,801
78708,1525,869,209,137,1316,793
78487,1540,930,203,131,1337,863
78158,1699,876,198,149,1501,808
78049,1716,938,198,151,1518,852
77533,1784,1065,197,159,1587,978
77019,1860,989,191,143,1669,898
78963,1803,981,213,149,1590,875
78810,1926,818,220,154,1706,705
75270,1985,713,237,160,1748,576
70164,1994,707,268,170,1726,572
65610,2120,638,272,157,1848,512
62358,2216,836,251,134,1965,725
60300,2167,959,289,180,1878,795
59168,2121,1082,272,203,1849,919
58786,2011,1090,257,195,1754,924
59486,2036,1122,245,193,1791,959
60002,2198,1169,262,205,1936,1012
62655,2224,1125,258,198,1966,985
66862,2114,1158,238,194,1876,1026
69728,2315,1284,241,225,2074,1128
71108,2512,1400,279,248,2233,1217
71445,2506,1475,308,299,2198,1246
70832,2492,1506,355,310,2137,1251
70095,2600,1484,385,312,2215,1228
69437,2698,1464,407,315,2291,1206
69397,2766,1421,423,318,2343,1152
69626,2825,1356,428,334,2397,1077
70108,2946,1314,415,347,2531,1046
70407,2917,1181,402,349,2515,918
71492,2645,998,372,332,2273,771
75392,2331,834,363,302,1968,744
76683,2042,764,364,278,1678,770
73018,1858,675,363,262,1495,672
68451,1807,779,380,258,1427,700
64681,1540,790,375,249,1165,691
62657,1604,773,382,254,1222,697
61885,1597,803,407,216,1190,715
62149,1537,801,369,227,1168,676
63837,1470,813,336,239,1134,669
68818,1507,773,330,241,1177,622
76673,1523,744,323,247,1200,584
81844,1366,650,297,258,1069,477
83366,1227,607,302,252,925,447
84100,1245,574,302,254,943,442
84911,1289,459,275,223,1014,405
85031,1404,496,239,195,1165,496
84677,1434,497,231,186,1203,508
84263,1367,461,239,193,1128,482
83326,1350,454,257,190,1093,453
82419,1328,473,302,212,1026,401
82169,1302,581,328,222,974,427
82029,1328,492,342,190,986,364
81523,1328,389,356,166,972,304
82209,1293,245,316,152,977,225
84971,1184,322,287,150,897,224
85209,1388,376,283,153,1105,289
79757,1562,587,296,152,1266,547
73617,1912,1195,302,155,1610,1166
69365,1921,1350,249,129,1672,1319
67231,1937,1396,228,125,1709,1384
66236,2001,1382,209,117,1792,1377
66193,1942,1376,161,87,1781,1360
67866,1812,1286,107,55,1705,1275
72945,1676,1244,98,35,1578,1241
80760,1765,1319,91,20,1674,1304
85024,1890,1390,95,33,1795,1380
85639,1979,1556,101,57,1878,1526
85425,2114,1695,144,116,1970,1608
85559,2111,1696,187,156,1924,1573
85414,2062,1687,200,167,1862,1547
85149,1928,1650,184,152,1744,1524
85329,1905,1587,185,170,1720,1447
85191,1886,1638,191,202,1695,1465
84875,2032,1699,213,247,1819,1476
85247,2129,1695,249,276,1880,1465
85235,2062,1581,243,267,1819,1363
84877,2121,1462,275,291,1846,1212
85283,2151,1292,316,321,1835,1020
87421,2146,1077,334,294,1812,867
87091,2117,1012,342,264,1775,875
81230,2117,1022,375,259,1742,943
74506,2110,1017,362,231,1748,966
69444,2158,1036,367,209,1791,998
66578,2209,1032,371,207,1838,1015
64964,2280,1043,371,213,1909,1024
64237,2339,1100,366,207,1973,1057
65252,2425,1140,364,197,2061,1069
69499,2463,1221,385,219,2078,1091
76673,2537,1267,403,241,2134,1085
81950,2491,1150,410,262,2081,937
84549,2329,1041,389,260,1940,844
86481,2325,1082,385,273,1940,846
88494,2535,1219,430,286,2105,941
89698,2577,1196,430,277,2147,939
90779,2310,1022,403,268,1907,782
92233,2144,942,403,276,1741,695
93262,1967,920,425,304,1542,660
93783,1826,877,439,311,1387,627
95096,1811,888,453,318,1358,641
95547,1780,782,444,309,1336,538
94715,1736,650,470,314,1266,416
93336,1690,461,497,302,1193,325
94347,1488,160,469,230,1019,184
93891,1361,132,450,203,911,292
87270,1325,161,437,176,888,308
79282,1453,198,476,170,977,315
72811,1744,243,478,187,1266,347
68949,1967,447,464,208,1503,471
66439,2196,662,472,231,1724,671
65342,2111,813,472,196,1639,761
65630,2138,864,484,171,1654,785
69314,2145,842,521,182,1624,774
76137,2014,811,496,179,1518,694
82246,1936,877,456,174,1480,739
86425,1700,667,399,183,1301,516
89485,1529,592,345,206,1184,425
92397,1389,635,322,229,1067,440
94217,1255,692,280,228,975,488
95724,1245,682,273,192,972,514
97158,1187,613,287,172,900,476
98031,1147,519,289,148,858,410
98605,1125,517,277,155,848,417
99221,1143,572,266,142,877,491
98665,1209,704,269,149,940,656
96532,1233,608,264,149,969,592
94655,1146,548,233,108,913,550
94591,1121,249,216,87,905,266
93383,1159,243,239,90,920,241
86316,1261,376,268,99,993,390
78204,1332,504,270,107,1062,545
72009,1357,504,244,109,1113,562
67771,1280,401,252,96,1028,465
65308,1145,277,236,75,909,335
64054,1101,309,232,88,869,383
64512,1094,341,250,104,844,440
68102,1055,316,233,96,822,407
74385,993,396,191,88,802,462
80363,950,554,166,67,784,594
84208,704,529,133,62,571,538
87143,650,556,110,74,540,552
89513,751,715,87,73,664,722
91375,821,852,69,65,752,866
92794,859,920,68,78,791,936
94127,920,983,68,78,852,998
94835,943,937,62,70,881,947
95334,997,919,64,74,933,916
95551,1046,922,65,73,981,925
94555,1075,915,65,67,1010,924
91808,1128,902,58,52,1070,910
88763,1141,770,58,57,1083,789
88529,1052,745,56,36,996,770
87460,1166,671,70,40,1096,700
81962,1345,641,83,35,1262,664
75064,1431,726,96,46,1335,731
69155,1548,845,115,59,1433,835
65252,1614,822,145,70,1469,810
62966,1622,739,166,84,1456,736
61630,1507,689,165,87,1342,704
61154,1438,630,178,80,1260,645
62125,1380,552,191,72,1189,574
63545,1308,475,185,66,1123,506
66752,1243,417,163,54,1080,452
71563,1007,455,122,29,885,471
75552,808,490,98,14,710,498
77942,746,381,90,41,656,412
79436,701,310,90,42,611,337
80265,687,380,84,52,603,404
80479,665,491,84,57,581,496
80539,741,645,93,75,648,640
80507,810,749,110,90,700,725
80849,907,868,125,111,782,830
81204,990,986,128,122,862,933
80863,1029,974,126,118,903,923
80339,1143,958,142,131,1001,898
81062,1232,868,178,161,1054,772
80874,1330,811,188,167,1142,721
76816,1553,693,172,151,1381,641
71324,1602,540,160,132,1442,499
66368,1619,509,165,133,1454,474
62798,1558,578,163,119,1395,546
60683,1471,559,145,104,1326,541
59329,1341,529,156,99,1185,502
58789,1290,607,158,101,1132,584
59308,1211,562,149,87,1062,544
59630,1195,539,155,84,1040,505
62370,1188,573,160,96,1028,533
67404,1008,606,128,89,880,582
72044,802,568,122,95,680,547
75544,883,581,135,92,748,550
78251,1039,656,161,94,878,612
80414,1206,723,183,114,1023,653
81623,1223,682,202,145,1021,580
82499,1262,692,213,159,1049,574
83637,1262,676,214,162,1048,561
85319,1361,742,221,196,1140,629
86740,1426,792,240,223,1186,697
87147,1483,823,228,236,1255,766
87155,1523,864,235,254,1288,797
88221,1477,784,241,235,1236,688
87723,1604,689,227,219,1377,595
82765,1726,460,207,205,1519,356
76682,1923,359,230,251,1693,397
71443,2022,500,218,218,1804,576
68152,2155,575,216,214,1939,653
66259,2149,606,209,221,1940,704
65615,2044,670,197,190,1847,734
66429,2012,626,191,171,1821,667
70825,1916,546,179,161,1737,580
78178,1929,479,192,228,1737,556
85080,1912,446,191,265,1721,544
89809,1604,427,175,283,1429,408
92969,1529,524,173,290,1356,499
96169,1652,463,173,283,1479,486
99098,1745,266,183,266,1562,364
101520,1888,335,180,236,1708,467
103967,1775,615,156,190,1619,708
105596,1729,640,150,169,1579,709
107509,1800,647,146,157,1654,718
109058,1805,438,144,144,1661,510
109791,1859,421,145,123,1714,499
108505,1823,575,149,89,1674,632
106510,1754,621,148,47,1606,632
105918,1598,544,167,52,1431,507
104566,1507,519,180,93,1327,464
96834,1583,633,210,128,1373,560
87601,1765,689,220,135,1545,641
80134,1690,638,233,155,1457,605
75257,1701,786,212,126,1489,740
72200,1491,659,175,94,1316,610
70521,1520,546,185,88,1335,492
70849,1569,562,212,106,1357,527
74653,1554,594,215,106,1339,563
81808,1551,640,188,112,1363,587
88241,1482,610,166,104,1316,548
92915,1350,467,177,136,1173,461
96381,1366,559,176,151,1190,602
100505,1372,509,155,127,1217,541
103961,1402,555,141,110,1261,563
107266,1379,608,123,113,1256,598
110750,1387,652,113,120,1274,616
113328,1425,679,113,103,1312,642
115499,1423,633,105,74,1318,587
116948,1462,552,100,55,1362,514
117529,1515,447,86,41,1429,420
115065,1530,274,110,37,1420,249
111805,1423,210,109,52,1314,192
110720,1248,263,160,94,1088,193
108405,1275,378,195,129,1080,282
100097,1451,608,204,155,1247,490
90433,1534,836,195,156,1339,756
82630,1633,1038,215,165,1418,927
77566,1696,1115,216,177,1480,983
74280,1721,1121,215,183,1506,968
72370,1669,1077,230,199,1439,893
72656,1673,966,246,217,1427,755
76467,1543,741,268,225,1275,522
83518,1517,515,266,214,1251,307
90409,1289,357,231,182,1058,200
94541,919,302,191,145,728,215
98148,723,246,149,126,574,185
102041,787,383,144,152,643,374
105890,853,426,143,165,710,428
108865,1009,488,193,215,816,490
111674,1196,486,239,236,957,486
113259,1360,620,254,238,1106,610
114955,1383,636,291,259,1092,597
115949,1401,643,317,284,1084,593
115439,1416,655,370,307,1046,577
112157,1402,550,369,303,1033,539
108378,1431,519,382,286,1049,446
107106,1380,510,358,269,1022,358
104507,1407,496,368,274,1039,349
96013,1453,521,356,253,1097,407
87089,1419,431,319,217,1100,352
79695,1362,354,285,181,1077,283
75019,1257,424,271,175,986,307
72052,1219,484,256,173,963,394
70463,1023,412,226,149,797,361
70851,953,383,208,140,745,354
74781,878,307,213,153,665,305
81909,792,258,194,143,598,237
88248,703,262,154,131,549,229
92003,546,260,110,115,436,184
94851,499,368,86,87,413,293
97457,589,560,82,80,507,492
98868,698,677,104,103,594,604
99804,862,796,138,136,724,717
100599,978,853,149,146,829,799
100933,1068,876,158,142,910,836
100496,1157,798,185,165,972,750
100011,1276,802,232,218,1044,705
98424,1397,832,246,223,1151,758
95971,1384,748,221,197,1163,688
93974,1383,770,199,170,1184,697
94053,1400,702,214,165,1186,613
92337,1527,586,228,168,1299,493
85556,1758,469,223,130,1535,438
77969,1875,377,222,88,1653,401
72108,1874,381,222,72,1652,411
68343,1839,421,227,47,1612,448
66157,1870,597,258,97,1612,627
65138,1889,717,295,144,1594,757
65796,1837,736,322,193,1515,748
69557,1758,702,322,219,1436,676
75789,1602,801,318,254,1284,728
81335,1567,667,305,275,1262,627
84336,1338,578,272,286,1066,504
85831,1297,694,269,294,1028,612
86405,1377,794,281,290,1096,741
86246,1463,810,291,281,1172,758
85251,1660,804,315,295,1345,776
84482,1835,835,342,306,1493,821
83108,1968,854,370,307,1598,874
81658,1943,817,383,313,1560,832
81055,1981,830,412,319,1569,831
80320,2010,835,405,325,1605,854
79334,1935,816,375,319,1560,863
78477,1881,847,334,306,1547,905
79285,1886,917,358,269,1528,936
79848,2022,943,384,231,1638,950
76086,2189,865,380,214,1809,834
70880,2309,889,365,213,1944,840
66209,2333,873,364,224,1969,816
63444,2205,863,365,226,1840,820
61697,2001,828,367,224,1634,798
60960,1860,780,357,237,1503,750
61177,1453,541,341,228,1112,492
62207,1288,546,339,215,949,504
63251,1241,461,342,233,899,396
66206,1209,519,313,228,896,464
69903,1238,914,266,251,972,893
72539,1185,1021,240,299,945,1020
73640,1153,963,243,333,910,935
73644,1151,950,244,338,907,914
73128,1233,1048,254,340,979,1014
71997,1314,1075,273,333,1041,1005
71018,1444,1076,289,335,1155,974
70454,1493,1134,293,335,1200,1064
70338,1602,1219,290,341,1312,1182
70589,1633,1239,293,342,1340,1232
70511,1657,1152,286,338,1371,1172
70550,1580,987,270,331,1310,1021
72528,1540,752,277,283,1263,769
74187,1633,518,293,246,1340,503
71287,1764,480,308,236,1456,452
66844,1872,673,317,213,1555,622
63043,1853,659,310,206,1543,606
60572,1733,589,314,202,1419,535
58987,1645,477,287,178,1358,417
58211,1475,415,251,168,1224,434
58261,1402,455,243,182,1159,499
58795,1456,450,240,181,1216,522
59100,1369,368,230,181,1139,475
61493,1284,388,194,163,1090,478
64823,1198,564,157,158,1041,643
66999,1132,676,163,216,969,728
68512,1331,799,193,274,1138,847
69012,1345,900,190,268,1155,898
69309,1306,792,194,255,1112,771
68883,1322,734,207,247,1115,704
68560,1456,766,227,238,1229,745
68751,1597,776,241,241,1356,769
69187,1682,838,244,236,1438,827
69842,1812,889,233,234,1579,891
70008,1733,864,227,205,1506,838
69487,1658,748,207,145,1451,683
71016,1480,577,177,108,1303,482
72577,1595,457,209,126,1386,351
69699,1838,618,238,162,1600,492
65427,2006,793,250,183,1756,658
61362,1990,688,246,174,1744,574
58848,1964,670,276,194,1688,530
57281,1903,666,270,205,1633,526
56726,1756,729,270,195,1486,608
56801,1646,641,258,186,1388,562
57733,1647,555,231,172,1416,495
58671,1618,455,200,161,1418,395
60889,1507,321,149,138,1358,245
64556,1379,316,99,101,1280,281
68227,1264,429,79,83,1185,388
70900,1327,396,66,64,1261,387
72508,1343,636,56,58,1287,621
73187,1436,722,71,72,1365,693
73173,1536,755,106,98,1430,733
73094,1663,930,139,108,1524,901
73229,1799,937,146,104,1653,918
73954,1755,769,155,138,1600,761
74773,1735,746,146,116,1589,730
74920,1742,799,147,93,1595,792
75336,1585,789,140,104,1445,783
77745,1503,823,172,124,1331,839
78136,1446,834,221,129,1225,832
73365,1583,967,235,109,1348,974
67837,1667,830,292,102,1375,860
63717,1746,831,303,113,1443,895
61050,1801,815,316,94,1485,882
59958,1887,794,312,100,1575,873
59651,1969,851,308,107,1661,944
60874,2067,837,316,132,1751,961
65254,2098,812,320,114,1778,920
72543,1993,839,308,126,1685,923
78971,1941,995,257,124,1684,1052
83236,1727,983,225,142,1502,1008
86278,1704,1060,198,139,1506,1075
89288,1878,1211,192,155,1686,1194
91516,2009,1267,161,137,1848,1255
93072,2048,1229,136,115,1912,1226
94799,2045,1061,120,99,1925,1076
95926,2145,1021,99,76,2046,1058
96627,2187,973,91,64,2096,1012
97676,2117,1073,97,60,2020,1098
97807,2090,1089,99,49,1991,1106
96814,1928,1077,106,53,1822,1096
95240,1782,1084,113,65,1669,1090
95628,1773,1036,152,63,1621,1017
94928,1878,881,196,72,1682,852
88086,1861,536,231,89,1630,528
80273,1873,377,248,111,1625,374
74272,1741,455,252,106,1489,429
70139,1721,561,273,131,1448,450
67784,1713,726,278,149,1435,584
66573,1642,777,290,162,1352,627
67235,1644,714,303,149,1341,593
71181,1702,820,298,141,1404,728
77828,1614,694,290,145,1324,623
84897,1421,588,264,152,1157,523
89957,1143,619,227,165,916,506
93920,1082,641,205,167,877,550
98351,1273,814,179,160,1094,726
102196,1340,811,146,114,1194,747
105604,1481,788,127,80,1354,740
109189,1597,708,142,76,1455,672
112161,1719,623,171,81,1548,603
114825,1736,588,193,122,1543,530
117082,1759,613,186,91,1573,546
117657,1738,657,180,105,1558,591
116350,1796,707,173,134,1623,618
113423,1714,630,147,113,1567,546
111657,1545,489,170,145,1375,369
110056,1525,559,210,171,1315,408
102124,1598,590,238,185,1360,419
92172,1591,620,223,182,1368,481
84191,1566,733,202,186,1364,600
78740,1449,691,196,180,1253,552
75082,1332,682,191,159,1141,561
73036,1299,727,167,152,1132,596
73025,1194,671,162,126,1032,582
76160,1179,700,186,121,993,620
82923,1200,744,196,99,1004,692
90932,1167,870,174,78,993,843
97733,1026,928,122,59,904,926
103832,1037,942,92,51,945,946
110429,1090,898,81,51,1009,904
115858,976,630,74,52,902,641
120048,981,615,90,52,891,624
123600,973,529,105,64,868,547
126218,991,532,127,75,864,561
127921,1089,437,168,84,921,482
129053,1178,361,192,88,986,399
128409,1242,432,210,99,1032,434
125551,1264,611,189,121,1075,596
121524,1222,600,187,129,1035,559
118635,1346,645,184,115,1162,607
116210,1404,676,190,92,1214,608
106831,1555,699,210,88,1345,618
96270,1506,609,206,75,1300,534
87484,1675,794,220,67,1455,733
81516,1667,891,205,83,1462,811
77659,1627,846,196,93,1431,766
75318,1729,924,194,105,1535,838
74956,1650,969,156,103,1494,900
77891,1619,1014,121,84,1498,969
84385,1647,894,94,70,1553,860
92650,1505,764,63,41,1442,747
99564,1349,735,39,29,1310,733
105831,1320,801,39,46,1281,814
111918,1364,674,74,116,1290,710
116787,1399,642,87,117,1312,671
120773,1329,557,89,84,1240,574
123656,1203,370,91,61,1112,379
125609,1070,144,91,44,979,160
126331,1009,213,91,49,918,216
126093,1082,381,85,54,997,373
124187,1186,461,75,59,1111,441
120171,1398,388,66,60,1332,363
115314,1443,320,70,64,1373,302
111618,1463,263,110,72,1353,227
109102,1596,232,151,59,1445,191
102113,1762,362,191,51,1571,321
93110,1789,429,210,52,1579,392
86341,1757,437,215,78,1542,374
80240,1774,490,233,103,1541,405
76436,1799,656,259,127,1540,546
73635,1689,729,241,152,1448,610
72158,1545,686,247,165,1298,535
72351,1539,705,262,188,1277,535
74041,1442,666,256,200,1186,517
79343,1229,529,218,179,1011,403
87294,1130,594,180,161,950,470
94769,1180,721,157,161,1023,608
101420,1361,1004,172,174,1189,900
106385,1477,1160,177,177,1300,1048
109983,1542,1145,180,164,1362,1028
112336,1510,1043,205,201,1305,895
114070,1455,939,214,171,1241,793
115511,1487,902,222,163,1265,756
116316,1493,847,232,169,1261,714
116203,1637,842,254,164,1383,739
113867,1576,836,261,152,1315,769
110171,1414,755,234,113,1180,708
107886,1355,726,246,103,1109,680
106314,1440,660,313,149,1127,591
100483,1612,656,341,170,1271,587
92145,1820,735,349,176,1471,669
85185,2038,861,353,172,1685,780
79620,2010,878,353,186,1657,773
75767,1971,942,352,191,1619,842
73183,1900,939,351,203,1549,834
71675,1902,931,333,196,1569,844
71096,1809,957,331,163,1478,868
70969,1615,935,331,141,1284,848
75064,1607,973,307,138,1300,884
81842,1505,1005,280,151,1225,931
88357,1443,973,235,142,1208,928
93435,1392,885,202,132,1190,843
96978,1415,877,209,157,1206,835
99270,1434,873,213,173,1221,831
100622,1507,883,228,200,1279,848
101296,1458,836,209,185,1249,814
102053,1500,839,189,153,1311,814
102594,1452,809,187,133,1265,779
102164,1351,763,189,107,1162,749
100192,1160,631,158,75,1002,611
97920,1035,474,147,64,888,465
97351,995,386,166,58,829,375
96653,983,348,184,54,799,315
91087,1054,465,199,60,855,432
83548,1133,641,196,76,937,578
77549,1290,757,203,101,1087,679
73697,1364,769,220,113,1144,687
71429,1383,784,227,126,1156,688
70316,1327,810,210,122,1117,701
70863,1238,756,202,116,1036,644
75034,1166,746,204,137,962,614
81461,1081,746,204,139,877,618
87776,900,660,184,141,716,530
91549,728,646,156,124,572,534
94641,633,619,137,112,496,527
97497,641,590,148,125,493,491
99646,723,651,162,146,561,541
101402,783,681,161,130,622,571
103105,778,601,158,130,620,490
103696,773,526,163,127,610,413
103546,802,520,172,133,630,404
103165,840,562,192,163,648,424
102993,832,453,175,108,657,382
100825,797,423,185,126,612,342
98491,714,320,172,104,542,270
97151,674,252,200,115,474,196
96396,713,240,241,133,472,165
89564,802,223,259,126,543,171
81035,966,263,259,108,707,215
74397,1033,325,243,107,790,280
69777,1026,297,231,106,795,261
67230,1087,231,253,119,834,224
65825,1078,169,250,131,828,205
66257,1060,167,262,132,798,178
69503,969,109,237,133,732,115
75052,934,92,210,132,724,66
81192,859,149,166,121,693,112
84763,750,122,147,115,603,166
87293,586,139,133,110,453,179
89870,597,224,133,114,464,224
91534,608,230,123,111,485,225
92773,621,228,106,103,515,249
94320,656,334,99,87,557,372
95474,683,474,84,60,599,498
96683,649,428,78,56,571,452
97906,724,388,91,69,633,428
98257,820,398,101,76,719,435
96645,854,424,88,53,766,442
93808,760,353,109,39,651,376
92438,804,305,155,70,649,359
92067,969,328,201,93,768,407
85598,1100,291,192,88,908,366
77626,1150,210,188,79,962,266
71308,1133,279,153,76,980,285
67645,1191,377,158,103,1033,322
65326,1211,499,180,128,1031,394
64171,1169,619,194,147,975,483
64851,996,595,162,134,834,461
68199,883,501,147,112,736,392
73894,890,452,135,109,755,348
80007,861,518,120,108,741,411
84239,762,601,103,93,659,509
87634,671,719,102,94,569,632
90682,754,825,119,101,635,746
93034,910,1003,138,119,772,917
95117,1051,1034,148,128,903,956
97370,1347,1212,193,165,1154,1143
98959,1496,1266,197,186,1299,1210
100488,1599,1305,206,208,1393,1259
101622,1693,1357,208,209,1485,1330
101578,1729,1307,201,183,1528,1313
99488,1811,1167,210,173,1601,1187
96632,1808,944,188,145,1620,969
95333,1575,736,215,149,1360,747
95133,1525,667,251,166,1274,620
88633,1757,838,256,193,1501,729
80524,1939,1078,288,197,1651,938
73995,1876,1050,306,206,1570,905
69909,1666,979,302,195,1364,846
67445,1430,815,295,207,1135,656
66263,1272,651,300,212,972,470
67031,1247,684,312,215,935,492
70707,1314,783,325,202,989,600
77037,1306,841,299,186,1007,683
82997,1137,794,261,182,876,647
87058,932,692,270,204,662,516
90119,881,668,295,218,586,462
92749,977,762,303,222,674,558
94175,1113,953,326,240,787,769
94828,1263,1313,342,277,921,1137
95270,1296,1442,333,288,963,1279
95278,1309,1499,321,292,988,1375
94937,1283,1525,290,275,993,1442
94722,1285,1603,272,264,1013,1551
94275,1253,1586,254,259,999,1544
92839,1217,1476,223,282,994,1445
91556,1237,1401,219,293,1018,1337
91532,1152,1187,196,219,956,1083
90689,1155,906,235,215,920,745
85246,1254,736,260,227,995,561
78446,1219,670,257,228,962,538
73034,1167,669,255,223,912,555
69370,1159,636,252,201,907,538
67296,1095,595,235,170,860,521
66487,966,639,200,124,766,566
67131,971,763,198,114,773,679
70979,981,807,194,104,787,717
76853,1010,784,196,75,814,716
82908,1017,849,188,89,829,768
86836,884,769,139,79,745,707
89566,947,894,131,87,816,832
91705,1218,1145,155,100,1063,1068
92960,1439,1231,177,118,1262,1126
93600,1514,1200,192,131,1322,1083
93837,1395,1095,214,155,1181,956
93611,1345,967,236,199,1109,799
92894,1369,944,234,206,1135,776
92346,1441,1020,251,215,1190,850
91327,1449,1141,270,246,1179,935
89635,1318,1068,263,268,1055,824
87966,1293,928,268,266,1025,676
87286,1333,899,286,258,1047,662
86603,1511,925,288,226,1223,739
82335,1568,773,293,230,1275,602
75975,1639,655,310,217,1329,576
70306,1424,562,333,191,1091,494
66597,1429,777,350,169,1079,662
64068,1410,827,352,153,1058,740
62766,1283,719,351,157,932,629
62522,1249,796,358,155,891,688
63267,1237,824,347,150,890,712
64422,1308,826,347,152,961,712
68183,1341,873,344,165,997,729
73400,1217,817,335,202,882,647
78046,1198,865,333,219,865,680
81534,1255,900,385,273,870,693
83383,1303,897,392,282,911,699
84577,1313,943,406,277,907,744
85324,1285,944,373,287,912,761
86040,1319,1010,378,286,941,859
87105,1350,1103,395,269,955,940
88521,1476,1209,411,277,1065,1019
89538,1490,1181,399,279,1091,1005
89189,1433,1164,365,276,1068,1020
87358,1254,1005,306,274,948,907
86118,1165,930,284,238,881,866
86501,1105,541,305,212,800,476
82297,1205,327,322,207,883,264
76311,1246,294,320,169,926,262
70636,1193,383,303,167,890,369
66628,1237,529,296,180,941,477
63949,1245,607,313,198,932,508
62205,1268,583,317,189,951,456
61361,1304,596,333,207,971,447
61266,1320,666,315,221,1005,515
61310,1237,669,286,218,951,509
64237,1174,616,253,187,922,471
69784,920,492,235,187,685,334
75552,852,452,252,207,600,270
80362,1036,558,277,241,759,384
84486,1213,644,302,265,911,494
87993,1289,668,331,285,958,527
90586,1329,694,346,299,983,543
92798,1366,770,338,300,1028,588
94762,1299,743,338,320,961,500
96371,1310,717,315,312,995,501
97363,1282,708,294,311,988,521
96545,1223,581,264,284,959,406
95007,1172,472,237,247,935,348
94998,1139,476,218,191,921,293
95099,1347,509,237,175,1110,340
90093,1612,572,243,167,1369,455
83255,1833,706,265,170,1568,625
77276,1960,772,274,166,1686,739
73306,1921,937,260,155,1661,892
71037,1920,1033,258,152,1662,969
69930,1826,996,229,129,1597,930
70669,1740,1017,221,117,1519,978
74646,1785,997,224,123,1561,969
81226,1679,938,204,139,1475,969
87851,1528,793,172,151,1356,842
92458,1239,710,128,143,1111,759
95921,1075,607,121,137,954,640
99418,1108,474,136,133,972,496
102002,1234,424,133,136,1101,453
103600,1452,460,133,135,1319,499
104867,1622,535,139,134,1483,557
105227,1791,528,156,139,1635,552
105215,1905,551,158,136,1747,571
105550,2036,572,150,123,1886,586
105511,2027,639,132,104,1895,646
104094,2059,589,127,111,1932,618
101996,1979,491,120,121,1859,549
100115,1789,444,133,141,1656,481
98212,1615,423,180,186,1435,474
92355,1820,442,225,218,1595,524
84519,1934,503,274,233,1660,617
78069,2064,588,304,227,1760,612
73693,2140,758,328,212,1812,684
71263,2043,898,350,194,1693,756
69825,1899,697,352,201,1547,565
70485,1852,708,356,185,1496,631
73992,1934,967,385,176,1549,877
80200,1815,922,406,148,1409,854
87262,1767,1136,435,178,1332,1027
92610,1496,881,407,181,1089,757
97280,1320,662,403,175,917,548
101866,1380,697,399,154,981,589
105534,1519,925,418,149,1101,819
108173,1619,1052,427,172,1192,926
110944,1646,1093,412,180,1234,963
112952,1692,1012,420,200,1272,864
114512,1747,819,445,226,1302,658
115916,1788,755,462,255,1326,568
115417,1724,649,450,238,1274,482
113528,1746,536,462,220,1284,368
110325,1664,463,465,212,1199,296
107878,1487,406,434,210,1053,220
106733,1552,346,434,227,1118,158
99750,1719,373,478,252,1241,288
90685,1790,475,488,261,1302,453
82770,1783,466,485,248,1298,456
77610,1864,487,464,239,1400,511
74095,1919,465,434,225,1485,530
72460,1981,454,439,237,1542,504
72862,1859,557,420,228,1439,525
75795,1853,706,389,189,1464,653
81710,1775,730,396,216,1379,619
89120,1584,646,391,221,1193,507
95057,1521,540,391,235,1130,394
100429,1437,601,375,257,1062,475
105572,1359,566,368,288,991,367
109901,1434,524,365,299,1069,236
114129,1552,496,359,292,1193,296
117814,1683,431,360,288,1323,287
120763,1761,403,361,287,1400,178
122828,1748,394,356,284,1392,135
124288,1769,373,352,300,1417,144
124053,1767,413,368,311,1399,291
121422,1765,485,371,315,1394,325
117841,1750,478,394,311,1356,298
115156,1628,425,382,315,1246,221
113199,1678,513,389,311,1289,226
104968,1715,541,383,301,1332,277
95231,1717,406,390,259,1327,211
87157,1684,398,405,225,1279,264
81930,1654,258,416,207,1238,186
78181,1475,318,412,188,1063,268
75718,1355,199,394,149,961,278
75674,1456,181,408,166,1048,228
78724,1715,576,416,167,1299,536
84190,1798,582,388,168,1410,529
90704,1629,652,376,189,1253,535
95753,1476,754,353,211,1123,628
99066,1482,765,356,227,1126,634
101862,1319,724,316,228,1003,589
104004,1180,651,282,222,898,540
105720,1050,660,239,198,811,551
108018,972,690,221,182,751,585
109606,986,717,228,169,758,624
109181,1049,744,245,162,804,648
107263,1143,768,290,179,853,636
105310,1233,682,314,188,919,558
102735,1264,570,307,211,957,451
99855,1290,569,295,231,995,437
97753,1114,601,307,229,807,398
95732,1139,512,318,232,821,327
89909,1292,461,331,220,961,319
82301,1495,453,340,217,1155,335
75160,1535,478,315,186,1220,377
70688,1602,438,294,158,1308,400
67985,1540,385,285,145,1255,391
66651,1541,405,279,139,1262,419
66719,1466,443,267,118,1199,471
69792,1312,397,250,116,1062,442
74489,1198,495,215,114,983,552
80543,1068,539,163,122,905,584
85202,894,479,142,124,752,530
88324,765,455,124,122,641,507
91154,756,416,124,122,632,466
92750,844,398,119,124,725,410
94304,990,471,153,167,837,433
95579,998,433,178,197,820,388
96440,1074,436,195,212,879,389
97528,1131,508,216,227,915,427
98821,1203,488,206,224,997,450
98916,1261,478,187,204,1074,504
96855,1209,477,164,174,1045,505
93689,1178,539,141,131,1037,538
90742,1125,497,127,101,998,509
90427,1296,481,148,97,1148,521
85765,1591,543,171,92,1420,586
78577,1737,530,209,90,1528,588
72100,1812,384,233,87,1579,452
67817,1789,389,243,77,1546,437
65010,1707,454,231,105,1476,446
63482,1700,436,224,146,1476,408
62887,1553,356,221,131,1332,319
63291,1372,229,200,120,1172,187
64295,1348,240,185,137,1163,141
68382,1214,289,137,125,1077,215
74209,1175,380,112,115,1063,339
79648,1161,528,121,131,1040,479
83805,1268,644,114,109,1154,632
86926,1378,741,117,111,1261,752
89295,1255,705,95,101,1160,706
90978,1221,760,85,86,1136,752
92557,1265,848,78,80,1187,840
94359,1285,831,78,77,1207,827
96005,1389,776,81,72,1308,770
96981,1430,687,69,58,1361,686
95990,1352,642,77,71,1275,626
93521,1269,636,81,62,1188,638
91570,1318,414,79,43,1239,429
91417,1420,253,95,47,1325,254
87225,1674,224,93,50,1581,215
80713,1788,168,101,69,1687,190
74685,2036,356,119,91,1917,384
70145,2159,400,126,70,2033,417
66799,2008,322,143,78,1865,344
64760,1872,234,164,82,1708,226
63905,1833,344,212,120,1621,315
63713,1645,411,206,101,1439,364
63807,1572,522,210,120,1362,458
66520,1467,562,228,161,1239,464
71985,1363,729,224,189,1139,586
77747,1420,885,238,228,1182,717
82654,1460,887,263,251,1197,770
87239,1531,926,286,274,1245,886
91161,1506,820,329,294,1177,767
93669,1408,696,304,307,1104,662
95579,1423,603,301,286,1122,572
97357,1499,602,308,269,1191,539
98692,1685,559,322,261,1363,549
99421,1691,517,296,236,1395,598
98750,1596,495,264,219,1332,594
97520,1504,456,228,135,1276,504
97158,1464,335,212,133,1252,431
97485,1511,265,249,149,1262,388
93168,1668,461,275,126,1393,483
86335,1719,609,304,101,1415,580
79547,1609,767,311,91,1298,751
74898,1607,785,305,105,1302,767
72237,1406,706,270,88,1136,704
70851,1237,613,230,95,1007,631
71552,1156,623,203,99,953,636
74921,1216,765,195,93,1021,773
80463,1234,832,184,107,1050,832
87952,1130,836,138,89,992,836
94702,935,773,103,81,832,781
100922,866,764,87,75,779,775
107216,871,789,96,65,775,793
112722,953,814,112,66,841,820
117069,987,801,117,51,870,794
121041,971,755,119,53,852,740
123787,900,755,128,65,772,732
125151,895,682,150,78,745,653
126030,897,672,167,100,730,624
125594,945,600,184,118,761,547
122772,1008,610,182,134,826,547
118174,934,654,161,150,773,586
114446,828,577,171,166,657,489
111621,1011,594,206,190,805,494
103332,1160,661,232,219,928,533
93495,1305,712,238,227,1067,543
85033,1409,693,223,210,1186,505
79632,1403,627,211,174,1192,460
76085,1475,661,219,162,1256,500
73962,1536,891,230,191,1306,701
73915,1537,1011,231,202,1306,812
76924,1512,1025,232,227,1280,810
82407,1472,942,215,202,1257,769
88992,1398,832,206,201,1192,675
93900,1318,800,189,195,1129,656
97913,1354,872,187,202,1167,720
101530,1399,867,195,211,1204,718
104266,1402,825,175,188,1227,717
106474,1349,681,122,110,1227,629
107454,1353,685,94,83,1259,639
107579,1516,858,103,84,1413,794
107205,1598,910,106,72,1492,853
106529,1452,841,118,79,1334,789
105376,1373,786,116,69,1257,740
103127,1236,777,97,51,1139,750
100490,1122,769,98,53,1024,737
98174,1095,727,123,44,972,705
96908,1145,694,158,32,987,690
91069,1334,649,195,55,1139,664
83332,1476,615,242,109,1234,647
76561,1449,497,208,92,1241,539
72106,1395,542,191,95,1204,572
69420,1392,580,196,89,1196,608
67983,1420,587,218,90,1202,624
68257,1372,540,207,95,1165,563
71286,1330,601,182,82,1148,592
76030,1407,620,200,98,1207,603
82317,1291,617,186,117,1105,578
87248,1071,730,147,150,924,657
90840,948,805,123,130,825,758
94176,792,720,113,102,679,681
96807,699,568,108,94,591,520
98815,649,499,106,88,543,437
100831,673,479,95,82,578,417
102143,826,594,86,77,740,539
103716,947,637,79,69,868,583
105248,1059,624,72,55,987,577
105590,959,541,68,52,891,499
104193,918,507,52,41,866,471
101060,846,468,42,27,804,441
98163,755,380,55,22,700,361
97179,897,302,67,16,830,288
90864,1173,368,81,32,1092,349
82519,1443,655,106,61,1337,622
75395,1484,779,115,89,1369,724
70806,1515,813,116,83,1399,750
68236,1505,817,117,78,1388,756
66937,1391,888,126,70,1265,827
67333,1318,948,149,75,1169,879
70325,1312,968,163,84,1149,897
75189,1354,1046,165,90,1189,977
81986,1242,1003,156,86,1086,948
87697,1012,938,115,77,897,917
92362,920,980,80,67,840,979
97206,929,968,85,69,844,960
100862,953,992,71,45,882,993
104146,1022,1069,58,34,964,1065
107283,1082,1145,58,38,1024,1126
109638,1220,1078,70,55,1150,1058
111553,1377,961,90,74,1287,920
113747,1511,930,108,98,1403,858
114138,1539,872,104,85,1435,804
112111,1368,678,110,87,1258,624
108431,1190,551,134,100,1056,516
104991,1025,503,167,128,858,454
103399,1089,558,222,177,867,442
96719,1420,751,255,210,1165,566
87897,1745,993,294,240,1451,779
80165,1848,1067,296,239,1552,853
74644,1845,971,264,222,1581,797
71277,1787,917,259,213,1528,751
69484,1877,921,281,207,1596,780
69434,1650,784,319,169,1331,681
71887,1577,615,318,133,1259,608
76414,1432,535,275,132,1157,546
83262,1293,577,241,180,1052,502
89921,989,561,201,201,788,445
95664,838,491,142,144,696,427
101084,901,554,143,141,758,498
105566,995,443,110,99,885,424
109131,1058,462,97,94,961,448
112081,1084,569,95,92,989,550
114265,1151,718,129,144,1022,683
115202,1333,767,159,169,1174,725
116063,1382,761,173,170,1209,722
115642,1356,749,166,178,1190,722
112764,1275,602,137,147,1138,613
108211,1119,485,132,145,987,497
104323,958,353,133,136,825,351
102697,922,387,155,132,767,339
96900,885,461,160,135,725,383
88740,918,366,188,152,730,259
81359,1036,397,197,151,839,264
75830,1120,446,185,131,935,338
72268,1152,521,198,111,954,444
70017,1097,522,219,107,878,445
68711,1049,519,230,131,819,434
68960,1052,550,239,136,813,432
69815,1041,595,230,148,811,475
74491,992,567,171,121,821,487
81244,950,677,119,112,831,586
88721,960,900,128,150,832,766
95562,977,1028,140,183,837,861
101287,817,844,146,195,671,669
105563,677,739,159,205,518,546
108921,741,649,170,186,571,475
111304,1021,833,184,167,837,696
113087,1260,916,189,170,1071,800
114582,1306,884,148,134,1158,810
114869,1456,974,111,88,1345,950
113075,1391,927,91,62,1300,915
109612,1404,1010,86,44,1318,978
105902,1498,1000,111,69,1387,939
104479,1703,1038,165,103,1538,959
98649,1562,1054,199,131,1363,971
90752,1386,903,221,142,1165,810
83470,1302,881,252,176,1050,738
77865,1348,960,265,205,1083,820
73873,1254,1029,268,236,986,843
71257,1207,1075,278,255,929,857
69487,1106,1085,281,246,825,849
69198,1020,1075,273,227,747,849
69071,1001,1092,231,228,770,865
73130,872,938,197,252,675,690
80579,859,902,168,244,691,670
88670,896,847,163,224,733,647
96542,953,749,190,236,763,573
103046,1020,626,214,225,806,507
108572,1022,585,234,222,788,485
112628,986,523,231,190,755,453
115858,939,421,213,171,726,371
118489,902,401,221,187,681,369
120554,957,420,197,156,760,435
120926,986,416,190,158,796,423
119304,895,366,195,173,700,377
115899,898,408,224,229,674,370
112504,838,437,246,250,592,347
111348,794,394,211,199,583,363
105348,864,398,210,186,654,373
96965,875,398,213,193,662,344
89309,828,384,202,177,626,310
83765,740,343,209,164,531,254
80376,680,292,216,159,464,226
78238,696,281,204,139,492,241
78345,753,371,181,120,572,317
81539,710,397,174,118,536,313
87254,704,414,164,118,540,315
96284,593,356,137,107,456,302
104417,449,261,100,94,349,245
112279,371,196,89,83,282,190
119439,294,152,80,63,214,153
125525,296,164,73,47,223,157
130476,379,237,74,56,305,223
134507,437,377,78,60,359,378
136379,419,386,98,64,321,362
136649,390,310,109,78,281,288
135958,462,359,121,90,341,341
134681,480,408,131,113,349,389
131966,539,471,125,111,414,448
125855,401,354,101,91,300,312
120836,415,306,111,78,304,249
117928,515,330,156,94,359,255
109619,590,375,174,105,416,287
99686,693,374,198,120,495,270
91159,916,376,211,124,705,281
85170,1156,543,227,123,929,480
81281,1407,625,227,116,1180,567
79082,1450,664,202,130,1248,571
79148,1475,582,172,117,1303,524
81852,1383,617,155,112,1228,550
87618,1395,659,159,117,1236,585
95810,1300,547,141,103,1159,492
103802,963,569,120,88,843,511
111054,837,635,131,107,706,548
118554,877,653,159,139,718,530
125240,867,605,164,150,703,475
130270,946,631,170,154,776,487
134692,1041,668,202,173,839,512
138149,1123,694,256,189,867,523
139781,1043,732,248,197,795,548
139241,1073,761,244,208,829,577
137246,1146,782,243,207,903,613
134543,1154,716,242,185,912,547
130388,1168,801,242,173,926,638
126522,1155,649,208,127,947,531
123273,1271,701,214,97,1057,614
114588,1403,806,223,95,1180,719
103777,1424,790,256,125,1168,668
94586,1346,678,251,155,1095,540
88170,1310,685,225,157,1085,554
83790,1346,765,230,167,1116,634
80856,1328,760,246,136,1082,670
80210,1446,874,269,136,1177,786
82841,1518,980,284,138,1234,901
88414,1435,900,280,142,1155,828
95793,1227,682,259,143,968,616
102266,974,441,195,130,779,442
107981,812,420,199,162,613,405
113930,724,386,200,181,524,328
118677,749,428,213,195,536,381
122919,616,288,201,193,415,236
127177,615,257,196,181,419,200
129902,681,216,197,191,484,197
131221,802,285,206,195,596,292
131571,897,324,208,192,689,346
130034,932,341,213,188,719,373
126425,879,388,201,165,678,426
121958,918,750,176,146,742,769
118606,911,845,178,119,733,850
115543,947,767,195,113,752,763
108174,1016,707,213,115,803,683
98693,1187,707,251,134,936,649
90461,1283,761,261,168,1022,661
84728,1321,704,256,180,1065,578
80996,1451,820,241,176,1210,693
78786,1490,867,226,171,1264,726
78961,1507,853,227,178,1280,694
81875,1583,939,251,213,1332,764
87443,1597,981,280,241,1317,787
94675,1561,978,288,276,1273,761
101465,1279,907,273,285,1006,659
106784,1146,948,270,281,876,687
112704,1307,1023,283,292,1024,752
117944,1506,1080,314,327,1192,778
121865,1625,1017,332,346,1293,692
125375,1684,942,320,340,1364,619
127290,1735,875,317,320,1418,568
128406,1782,817,308,303,1474,526
129348,1887,760,302,302,1585,511
128841,2051,733,299,281,1752,577
125487,2041,715,312,310,1729,590
120679,1858,576,314,312,1544,478
117498,1738,470,329,286,1409,403
114612,1842,440,348,259,1494,367
107746,1889,422,314,193,1575,422
98743,1883,436,298,135,1585,452
90492,1862,444,287,134,1575,459
84963,1838,362,260,126,1578,409
81172,1853,404,243,114,1610,389
79063,1745,447,227,97,1518,404
79047,1623,499,206,63,1417,466
81751,1638,520,193,81,1445,464
86583,1676,527,216,106,1460,439
94187,1517,604,203,128,1314,506
101475,1255,537,180,118,1075,453
107691,1080,467,180,123,900,383
114097,1099,469,181,150,918,381
118873,1123,431,185,156,938,358
122405,1248,416,196,154,1052,379
125223,1432,347,211,163,1221,376
126664,1595,421,234,156,1361,472
125906,1770,426,260,148,1510,476
123672,1865,363,261,154,1604,445
120110,1926,344,295,153,1631,411
115371,1889,456,285,168,1604,496
110933,1776,393,282,178,1494,418
106727,1586,320,286,203,1300,314
104447,1527,275,329,208,1198,205
98574,1609,408,388,195,1221,321
90820,1566,468,419,205,1147,390
83190,1446,505,391,223,1055,440
77957,1503,705,359,176,1144,678
74193,1443,789,333,164,1110,775
71784,1294,642,310,144,984,631
70742,1180,453,279,121,901,431
70893,1032,278,268,92,764,255
71698,933,261,263,90,670,287
76032,759,312,193,87,566,327
82730,573,290,129,67,444,298
89072,526,281,113,60,413,296
94466,541,312,111,44,430,331
98886,612,272,130,56,482,285
102037,624,293,134,32,490,282
104191,675,344,156,49,519,299
105515,670,393,163,74,507,321
107338,717,324,178,93,539,251
108690,737,341,167,90,570,282
108569,674,421,151,89,523,363
106672,692,424,138,83,554,379
103206,705,446,133,66,572,433
100254,732,416,162,61,570,418
99428,925,456,213,94,712,434
94732,948,534,217,86,731,509
87970,971,628,170,78,801,588
81655,1077,727,163,69,914,677
76759,1015,686,155,77,860,627
73421,1002,595,153,73,849,543
71164,927,424,147,77,780,374
70001,743,316,134,79,609,282
69959,821,369,151,88,670,321
70030,799,387,148,106,651,355
72917,761,350,126,103,635,315
78843,688,352,82,83,606,338
84865,751,544,64,75,687,542
90610,802,598,70,84,732,617
95800,825,575,76,89,749,603
99964,865,608,60,71,805,623
102753,896,670,67,53,829,681
103656,928,647,93,62,835,649
104159,1053,643,111,86,942,660
105247,1085,627,126,81,959,638
106171,1051,547,117,68,934,555
105074,951,661,118,55,833,649
102492,960,691,119,63,841,671
100801,908,627,160,99,748,598
100097,895,549,183,72,713,535
95463,908,498,213,94,695,492
88393,992,461,214,93,778,466
81789,1137,527,220,104,917,543
77418,1114,430,208,81,906,459
74955,1101,365,215,83,886,405
73506,1252,431,209,90,1043,463
74087,1220,447,197,92,1023,479
77592,1259,443,212,110,1047,462
83221,1158,359,216,115,942,412
89303,1016,347,194,103,822,379
94710,914,322,148,89,766,352
99166,1006,409,143,104,863,445
102934,1143,383,182,103,961,436
105619,1194,329,227,111,967,402
107508,1200,349,243,141,957,457
109705,1265,450,277,173,988,567
110846,1400,599,304,170,1096,705
111482,1509,702,289,123,1220,784
111820,1642,731,281,95,1361,802
111549,1565,764,276,107,1289,844
109475,1426,815,229,86,1197,871
106983,1240,763,199,69,1041,788
105216,1120,640,196,73,924,660
104284,1163,537,208,93,955,515
98236,1295,499,210,125,1085,420
90250,1367,511,226,144,1141,404
83460,1400,631,254,180,1146,490
78769,1327,696,237,184,1090,545
75957,1186,665,209,175,977,521
74399,1121,633,196,168,925,502
74684,1046,522,184,158,862,406
78094,1018,456,185,180,833,336
83720,895,372,155,164,740,303
89772,756,363,142,152,614,285
94846,666,318,112,121,554,272
99268,640,298,121,125,519,292
103370,541,273,120,104,421,271
107073,540,269,120,88,420,289
110021,592,292,133,79,459,321
112966,596,281,135,77,461,312
115005,595,291,130,66,465,317
115761,583,304,113,64,470,328
115767,609,346,104,55,505,357
115057,630,416,110,56,520,400
112449,589,424,112,72,477,380
109270,595,450,126,107,469,364
107239,653,389,133,118,520,308
105816,687,348,143,116,544,297
99542,790,360,137,95,653,373
91166,810,438,127,83,683,474
84070,735,424,123,84,612,469
78961,665,368,121,92,544,412
75938,750,531,116,93,634,582
74375,735,526,109,96,626,578
74646,731,486,97,76,634,540
77906,714,424,79,78,635,474
83488,681,354,69,82,612,396
89978,600,285,59,69,541,325
95878,407,192,35,42,372,216
101010,262,91,32,30,230,106
106215,262,129,39,26,223,127
110887,317,157,50,29,267,154
114618,400,161,69,48,331,163
117832,520,273,78,66,442,265
119956,628,282,81,70,547,264
120900,705,307,99,82,606,279
120868,830,376,154,122,676,308
119987,816,324,144,116,672,295
116754,734,261,135,97,599,267
112483,676,279,148,97,528,301
109396,619,263,171,80,448,275
107601,664,202,195,50,469,243
101412,748,202,226,56,522,218
93743,797,256,252,82,545,216
86436,783,357,219,98,564,305
80979,822,497,208,90,614,434
76952,819,562,201,91,618,490
74608,851,605,208,106,643,511
73544,807,570,174,85,633,494
73993,747,495,188,103,559,396
74721,737,546,187,133,550,413
77707,700,505,177,104,523,404
83605,563,332,179,95,384,244
90555,455,255,185,119,270,147
97272,432,300,186,147,246,159
103067,456,365,189,182,267,192
106902,509,403,221,209,288,199
109883,543,387,231,210,312,181
111755,582,385,238,219,344,180
113165,641,359,245,218,396,179
114194,651,338,246,216,405,169
114001,628,336,246,219,382,165
111579,592,323,229,224,363,146
107433,595,294,267,200,328,148
103500,603,266,266,170,337,133
101019,621,311,267,171,354,196
97213,696,373,273,154,423,265
92144,728,401,268,152,460,283
85783,708,389,258,151,450,259
80414,743,397,272,153,471,256
76799,772,400,275,146,497,272
74504,777,370,257,129,520,256
73930,667,421,209,145,458,278
75739,621,407,174,135,447,274
79262,626,378,161,132,465,248
85882,738,385,161,104,577,303
93505,633,402,156,98,477,316
101162,416,277,148,99,268,182
108281,396,287,155,124,241,172
113858,439,326,124,82,315,253
118107,476,332,119,81,357,289
121520,505,330,114,75,391,313
123941,481,319,94,47,387,309
125755,488,268,101,56,387,257
127163,496,201,111,76,385,177
127280,532,160,105,76,427,129
124588,466,106,95,47,371,63
120072,408,72,82,24,326,53
115536,488,107,108,27,380,111
113371,639,121,135,26,504,126
107227,859,94,157,37,702,105
99010,1027,124,166,55,861,134
91278,1273,283,165,48,1108,305
85413,1435,406,149,42,1286,439
81058,1361,413,123,33,1238,433
78146,1273,442,118,38,1155,455
76637,1112,454,124,44,988,450
76521,1019,472,117,47,902,468
77079,1040,563,98,39,942,566
82601,927,501,68,42,859,500
91171,772,526,41,41,731,526
99924,665,569,39,45,626,569
107966,747,615,50,44,697,607
113852,914,732,56,48,858,712
118380,820,631,55,39,765,602
121461,635,488,62,49,573,449
123232,624,484,76,65,548,432
124684,759,627,89,81,670,559
125510,937,745,101,82,836,679
125196,1088,810,106,55,982,766
123049,1063,811,96,26,967,791
119016,924,780,90,46,834,751
115083,937,723,108,41,829,685
113207,1090,797,140,53,950,754
107366,1341,897,184,74,1157,843
100100,1510,971,217,94,1293,908
92705,1555,1022,237,109,1318,931
86628,1617,1016,255,138,1362,897
82239,1556,1001,265,152,1291,871
79201,1578,949,265,142,1313,823
77121,1606,902,275,123,1331,797
76200,1502,778,260,114,1242,690
75833,1429,697,259,142,1170,601
79666,1258,654,267,179,991,510
87149,990,626,216,188,774,494
95544,903,643,213,202,690,507
102980,1005,784,219,189,786,703
109128,1017,735,228,170,789,662
114016,1051,574,221,167,830,489
117846,1168,591,239,176,929,522
120512,1202,547,252,189,950,474
123056,1197,524,235,159,962,481
124724,1108,461,240,159,868,406
125041,1112,392,270,168,842,352
122508,1164,347,280,152,884,292
118470,1106,290,255,115,851,273
115082,1161,336,274,159,887,352
112549,1326,299,335,149,991,312
106230,1449,135,355,189,1094,156
97865,1607,225,354,212,1253,157
90277,1615,356,348,197,1267,311
85026,1584,487,328,187,1256,400
81387,1523,464,322,181,1201,370
79625,1591,455,309,144,1282,392
79818,1599,602,259,121,1340,528
82907,1680,948,248,165,1432,807
88416,1716,1082,232,186,1484,913
95815,1496,953,191,182,1305,783
102517,1383,972,141,139,1242,844
108543,1370,964,142,133,1228,848
114973,1379,915,153,163,1226,769
120182,1343,810,142,147,1201,684
124326,1469,894,156,145,1313,758
127562,1484,917,194,159,1290,771
129937,1515,884,187,148,1328,763
132018,1723,994,227,188,1496,855
133360,1851,1062,220,211,1631,936
132818,1981,1162,237,251,1744,1028
130265,1813,1087,221,263,1592,934
126709,1540,975,193,250,1347,821
123128,1327,747,188,193,1139,603
120484,1366,735,209,208,1157,556
112519,1614,751,226,210,1388,581
102918,1695,859,225,189,1470,715
94274,1661,848,232,187,1429,708
88397,1652,803,219,163,1433,689
84385,1686,739,184,112,1502,666
82100,1585,680,157,86,1428,627
82115,1504,697,152,102,1352,638
85326,1413,713,152,115,1261,640
90904,1271,611,146,104,1125,534
98151,1094,510,132,91,962,460
104845,805,424,101,87,704,402
111286,701,452,90,68,611,434
117320,836,496,127,73,709,455
122838,995,523,175,104,820,453
127278,940,498,214,127,726,379
130477,923,509,250,145,673,369
132475,965,511,268,164,697,358
133397,1008,541,298,194,710,364
133292,1055,547,317,214,738,351
133329,1059,579,317,222,742,379
131448,1020,517,280,209,740,355
127472,942,419,225,179,717,296
124744,860,409,219,182,641,288
122250,955,429,262,212,693,296
114987,1063,468,281,240,782,344
105614,1086,486,278,223,808,381
97409,1087,606,289,211,798,486
91576,1057,674,262,185,795,544
88009,997,638,246,164,751,529
85865,963,666,231,154,732,582
85869,915,608,232,167,683,524
89186,884,552,227,168,657,472
94918,850,525,214,157,636,457
102248,819,483,215,170,604,381
108936,677,457,197,176,480,322
115204,540,429,168,171,372,298
121007,594,468,164,173,430,324
125861,582,444,144,158,438,298
130138,460,347,136,150,324,210
133135,412,313,124,141,288,190
134626,391,306,135,149,256,198
134243,410,324,139,153,271,240
133377,450,353,130,141,320,279
131830,537,411,121,112,416,350
128211,659,547,123,102,536,469
123455,766,641,128,115,638,541
119999,748,591,154,150,594,469
116935,758,524,133,92,625,462
109350,769,482,117,64,652,444
99915,746,417,91,33,655,403
92044,699,379,90,53,609,378
86292,674,360,87,66,587,365
83104,657,332,78,72,579,345
80870,651,336,67,68,584,344
80783,666,365,60,55,606,362
84205,676,371,68,63,608,369
89400,659,343,78,79,581,341
95089,611,303,70,77,541,293
100477,451,215,50,59,401,202
104630,294,194,31,37,263,189
108963,331,272,20,20,311,267
112680,392,286,15,21,377,284
115756,400,269,19,26,381,269
118714,395,273,18,23,377,277
121210,425,306,18,20,407,306
122945,511,392,19,25,492,395
124013,617,456,26,33,591,473
123536,660,512,40,47,620,543
120557,629,502,64,79,565,544
116621,591,446,43,46,548,473
113164,591,416,42,39,549,432
110881,684,526,62,50,622,546
104281,830,690,82,52,748,708
94867,975,839,99,49,876,833
86739,1047,988,122,67,925,939
80980,1139,956,133,70,1006,905
77312,1182,928,126,65,1056,881
75241,1176,928,121,65,1055,879
75149,1142,915,110,59,1032,873
77962,1010,701,115,60,895,665
82409,889,550,119,63,770,514
88057,775,476,99,57,676,455
93243,627,392,56,43,571,394
97799,459,324,32,23,427,321
101711,342,267,26,18,316,255
104564,422,381,35,31,387,353
106523,511,443,41,38,470,407
107992,581,518,48,41,533,478
108720,690,677,53,38,637,642
109076,685,686,66,40,619,652
109263,704,662,74,47,630,627
108870,688,642,77,46,611,602
106798,676,598,92,56,584,557
104202,621,477,106,56,515,450
102207,547,410,121,81,426,389
100664,684,493,156,87,528,489
95627,965,593,184,86,781,587
88078,1116,552,192,78,924,529
81643,1285,606,210,80,1075,564
76696,1346,575,204,87,1142,512
73305,1349,576,205,106,1144,486
71406,1284,624,194,107,1090,531
70567,1174,604,190,86,984,531
71232,1047,415,189,95,858,338
71975,1016,475,194,105,822,384
76042,934,489,176,126,758,379
82961,849,443,149,130,700,345
89894,666,453,120,141,546,366
96230,638,408,107,147,531,313
101436,728,464,120,154,608,392
105446,729,456,137,161,592,405
108392,789,494,133,144,656,474
111063,828,485,149,173,679,486
113402,809,411,167,183,642,410
115444,834,418,169,164,665,426
116221,853,393,171,153,682,395
114978,1009,464,186,173,823,452
111939,1119,678,184,154,935,669
108989,1062,468,197,135,865,432
107496,1145,518,189,72,956,505
102323,1240,596,207,47,1033,594
94769,1269,538,222,50,1047,528
87805,1483,636,248,73,1235,606
82319,1593,844,231,76,1362,788
78627,1638,920,220,79,1418,863
76286,1505,783,217,67,1288,738
75004,1299,637,183,24,1116,626
74612,1215,637,171,39,1044,610
74214,1182,685,165,64,1017,631
78466,1131,713,147,96,984,634
86664,1037,712,150,123,887,604
95691,867,682,162,154,705,542
104457,868,693,162,172,706,555
112013,888,670,147,139,741,590
117532,930,696,132,108,798,660
121543,1065,754,131,118,934,713
125180,1229,864,131,125,1098,805
127931,1347,915,146,144,1201,826
130358,1343,907,143,134,1200,812
131617,1275,895,139,122,1136,814
130709,1224,778,132,108,1092,717
127636,1160,698,125,80,1035,678
123874,1112,543,125,48,987,544
121796,1156,487,177,70,979,484
115044,1344,510,199,107,1145,508
105950,1524,537,213,126,1311,537
97282,1587,537,223,131,1364,526
91245,1539,473,204,116,1335,461
87151,1472,405,209,108,1263,392
84711,1386,419,215,91,1171,417
84612,1360,507,218,97,1142,512
87455,1352,512,220,78,1132,506
92764,1242,453,208,55,1034,458
101859,1052,436,193,38,859,430
111509,823,433,168,42,655,422
120441,703,484,147,54,556,476
129281,745,577,154,68,591,572
136678,744,656,114,37,630,653
142216,807,693,150,82,657,681
146369,899,724,191,115,708,679
148697,979,777,205,128,774,714
149212,1038,693,221,136,817,650
150116,987,646,232,138,755,610
150315,927,607,245,124,682,567
148719,896,587,231,121,665,543
145274,707,389,185,102,522,389
141014,646,265,203,108,443,247
137762,738,274,227,127,511,218
128042,842,232,215,99,627,162
116710,794,148,205,81,589,75
107079,799,146,225,86,574,74
100286,838,201,238,100,600,136
95344,843,222,226,87,617,167
92445,792,291,208,81,584,218
91546,727,372,174,87,553,291
93932,647,345,136,70,511,279
98904,633,325,140,69,493,260
106990,585,288,123,64,462,229
115956,366,215,80,46,286,170
124953,217,140,55,40,162,101
133169,189,87,48,27,141,65
140011,243,131,48,36,195,112
144549,315,181,60,49,255,153
147562,374,203,74,58,300,186
149769,511,380,79,51,432,403
150737,559,466,83,55,476,491
151421,581,556,75,51,506,577
151379,579,579,73,57,506,600
149577,589,595,70,55,519,619
145755,534,523,61,48,473,539
141359,518,467,71,49,447,479
137626,643,567,89,42,554,572
128295,771,623,93,55,678,615
117426,883,549,98,56,785,539
107605,929,484,96,54,833,471
100399,1081,707,91,51,990,672
95607,1169,765,90,52,1079,728
92400,1263,764,104,61,1159,716
91799,1217,677,119,71,1098,632
94498,1253,749,123,77,1130,712
99441,1104,666,130,95,974,636
107586,1032,697,123,104,909,688
116914,855,679,97,96,758,686
125752,675,610,87,80,588,618
135007,595,525,95,84,500,531
142562,618,574,99,86,519,587
147243,703,789,103,90,600,802
150767,875,1112,111,81,764,1113
152459,864,957,119,82,745,948
153278,950,1063,128,91,822,1039
154044,936,932,135,76,801,891
153964,966,935,134,80,832,882
152130,899,742,135,63,764,690
148325,713,515,129,73,584,473
144214,729,521,146,84,583,464
140161,861,636,191,103,670,560
131379,949,720,226,116,723,625
120206,1101,822,268,134,833,704
110670,1282,1002,281,157,1002,859
103711,1382,1132,287,179,1095,967
98862,1416,1040,292,201,1124,846
95738,1273,846,296,192,977,665
95089,1160,732,274,172,886,573
97657,1126,734,268,182,858,609
102548,1027,700,237,179,790,611
111138,881,636,197,152,684,554
120478,612,483,129,114,483,409
129951,483,450,124,130,359,330
139284,421,428,119,132,302,297
147102,363,324,95,82,268,244
152045,373,297,92,74,281,234
155271,496,343,115,100,381,269
156146,571,469,100,84,471,421
156740,668,617,113,108,555,549
157509,784,788,121,107,663,718
157049,778,705,134,128,644,628
155556,701,492,128,109,573,423
152000,664,383,128,90,536,337
148323,678,248,147,95,531,220
144957,694,151,133,69,561,157
136263,946,221,144,55,802,222
125493,1149,374,162,87,987,371
115966,1191,514,181,110,1010,471
108726,1203,602,181,95,1022,550
103625,1213,637,179,75,1034,589
100439,1207,644,183,90,1024,588
99340,1115,670,193,112,922,601
101524,1065,672,194,100,871,604
105775,1016,692,173,66,843,648
113704,919,625,142,45,777,597
123026,708,461,103,38,605,446
132514,656,395,96,44,560,376
141890,699,432,97,64,602,400
148878,731,475,95,85,636,446
152888,748,574,112,93,636,534
155475,840,648,115,80,725,620
156077,999,780,128,74,871,744
155775,1093,867,144,79,949,822
155104,1063,797,185,64,878,756
153174,1111,747,208,62,903,721
149471,1143,711,201,94,942,693
144491,1034,636,193,102,841,644
140282,1030,559,204,125,826,584
136702,1100,599,224,121,876,622
128134,1042,750,229,119,813,721
117575,985,739,228,119,757,679
108506,923,585,204,104,719,519
101619,900,568,184,89,716,510
96637,988,697,196,110,792,629
93023,1013,758,208,136,805,673
90764,897,637,211,161,686,517
90141,821,597,192,135,629,485
90572,721,516,167,105,554,427
94116,631,452,137,84,494,374
101054,558,409,113,89,445,327
108521,464,367,86,68,378,313
115843,464,340,87,55,377,302
122087,480,300,95,68,385,266
126489,475,246,91,68,384,215
129544,441,272,100,98,341,218
131337,405,267,111,103,294,201
132960,415,234,121,109,294,155
133361,358,207,118,86,240,136
132580,414,262,124,85,290,183
129432,372,218,120,91,252,132
124816,348,105,125,64,223,62
121352,368,99,129,48,239,63
118400,476,108,152,65,324,73
111527,570,113,157,74,413,85
103038,576,116,141,79,435,88
95173,617,138,120,68,497,133
89228,673,223,118,71,555,224
84774,727,374,113,74,614,373
81555,680,424,102,64,578,418
79916,679,479,80,44,599,468
79165,669,434,74,39,595,423
78783,670,400,68,36,602,393
81956,633,339,69,37,564,335
88824,461,236,56,40,405,223
96477,289,188,40,33,249,181
104062,259,193,34,24,225,191
111180,278,233,31,30,247,217
116812,296,292,26,32,270,265
120994,305,325,28,43,277,286
123617,372,347,44,61,328,294
124636,485,441,80,127,405,350
124607,477,401,82,124,395,311
123368,487,405,78,100,409,345
120727,566,534,71,71,495,502
117089,507,448,93,86,414,386
114871,512,440,138,107,374,353
113476,698,586,164,119,534,496
107055,927,787,197,146,730,686
99319,970,780,215,166,755,647
92260,889,671,236,185,653,512
87081,948,722,240,202,708,550
83943,942,698,221,195,721,535
82371,1124,1051,210,188,914,891
82741,1181,1244,207,207,974,1061
86322,1052,1044,215,229,837,857
91962,953,797,203,218,750,634
98591,871,640,188,207,683,515
104857,654,451,161,197,493,369
110689,463,302,141,178,322,228
116151,449,315,123,157,326,252
121607,518,401,140,158,378,390
126181,544,398,191,211,353,378
129943,496,340,182,196,314,290
132081,507,286,169,172,338,243
132862,482,303,190,169,292,260
132767,553,354,181,156,372,341
131666,566,404,169,148,397,379
128909,560,368,167,157,393,332
125143,477,279,148,107,329,261
122746,530,309,164,85,366,302
119444,643,342,208,95,435,326
111917,772,317,248,117,524,295
102760,1010,394,272,142,738,388
94786,1147,508,262,148,885,512
88946,1210,641,253,138,957,635
84843,1222,721,258,128,964,689
82815,1343,840,258,128,1085,803
82944,1381,859,251,106,1130,842
86106,1431,898,230,95,1201,881
91525,1418,919,214,97,1204,889
97675,1282,874,182,76,1100,829
103948,1070,785,127,58,943,747
110104,960,716,109,54,851,690
116393,952,681,131,73,821,663
121743,898,608,153,55,745,609
126201,962,601,179,69,783,621
129951,1019,629,177,86,842,662
132470,1108,719,210,84,898,711
133700,1157,773,212,77,945,752
134385,1188,826,220,88,968,788
133664,1209,856,223,93,986,806
130503,1194,916,252,128,942,825
125252,1060,794,210,112,850,711
120602,923,631,198,108,725,543
117069,1042,601,235,118,807,498
108760,1106,646,246,155,860,529
99075,1069,615,231,167,838,493
90635,1108,685,238,195,870,534
84928,1213,720,238,209,975,572
81137,1362,774,233,204,1129,628
78973,1287,738,185,182,1102,595
78665,1144,622,170,166,974,498
81563,999,542,155,135,844,436
86326,937,494,149,123,788,404
92359,959,496,130,111,829,415
97994,793,484,123,113,670,396
102898,1135,1105,126,115,1009,1026
106645,635,372,142,123,493,316
109180,685,427,145,132,540,446
111694,739,561,139,122,600,593
114271,762,535,155,146,607,567
115974,760,510,170,169,590,529
116952,824,481,185,181,639,477
117463,877,515,191,176,686,538
117036,754,427,193,151,561,451
114177,677,424,216,130,461,384
109706,579,418,173,110,406,393
105991,508,361,160,112,348,310
104047,634,417,175,112,459,339
96983,932,606,157,97,775,555
88190,1056,545,156,102,900,475
80839,1069,372,135,82,934,336
76022,1068,329,112,57,956,344
72772,1005,377,102,53,903,395
71035,968,406,106,63,862,417
71105,1066,469,108,68,958,479
73988,1059,467,108,81,951,485
78490,1076,473,108,104,968,488
83268,943,432,91,102,852,415
87593,615,297,56,78,559,286
91022,462,236,43,58,419,227
94674,485,246,45,55,440,257
97372,409,207,45,65,364,208
99600,416,225,49,83,367,235
101934,505,361,56,100,449,379
103564,655,550,60,106,595,571
104917,692,557,82,140,610,578
106125,692,569,94,164,598,575
106319,550,519,64,92,486,522
104389,497,460,46,41,451,462
101283,481,356,51,43,430,359
99564,474,315,88,59,386,320
98704,619,388,120,75,499,388
92729,892,657,164,98,728,636
84881,1069,821,190,119,879,752
78278,1250,954,221,149,1029,847
73760,1252,992,219,155,1033,888
70978,1292,926,243,145,1049,842
69704,1195,836,257,158,938,732
70043,1088,773,230,159,858,659
73039,916,532,203,169,713,431
77333,861,380,166,130,695,335
82931,857,433,138,110,719,377
88538,731,470,128,166,603,339
93557,558,447,101,141,457,338
98356,528,445,84,115,444,375
101699,543,482,98,116,445,416
104459,529,497,99,112,430,447
107181,569,570,113,121,456,499
109491,589,535,119,122,470,460
111316,573,466,114,121,459,385
112673,650,561,103,108,547,493
112640,830,619,135,153,695,505
110393,805,484,118,116,687,412
106215,644,401,109,91,535,370
102789,637,338,142,104,495,295
100913,645,372,160,107,485,337
94769,628,418,156,114,472,377
87220,758,474,171,111,587,418
80292,760,468,211,145,549,383
75443,748,456,210,156,538,346
72321,835,537,224,171,611,395
70132,810,508,233,164,577,379
69103,881,657,227,161,654,520
69759,887,658,224,177,663,507
70713,864,608,210,186,654,450
74063,819,587,187,176,632,436
79601,597,471,139,142,458,344
85505,501,414,109,117,392,310
90772,516,440,107,112,409,335
94378,618,537,92,95,526,445
96769,797,654,94,105,703,558
98222,997,780,91,87,906,703
99267,1161,957,76,73,1085,903
99658,1339,1123,67,55,1272,1078
99998,1400,1150,60,50,1340,1113
99065,1395,1135,56,51,1339,1100
97082,1393,1141,80,66,1313,1081
94394,1315,1148,91,77,1224,1090
93159,1089,967,93,89,996,904
92503,992,819,91,90,901,759
88115,993,794,115,118,878,696
81932,1066,798,119,117,947,693
76267,1146,848,129,146,1017,711
72123,1133,836,109,118,1024,729
69160,1066,805,91,97,975,718
67463,1020,792,84,84,936,711
66550,1030,799,89,100,941,703
66902,1066,818,122,142,944,684
66899,1116,875,136,155,980,727
69020,1032,871,113,151,919,725
73864,893,932,128,171,765,762
79212,949,1070,144,181,805,890
83978,1048,1074,146,180,902,906
87629,1081,1051,144,186,937,898
90548,1121,1082,156,186,965,925
92816,1128,1083,163,206,965,920
94776,1086,1063,168,214,918,902
96745,1097,1039,189,247,908,844
98023,1167,1104,199,252,968,885
98833,1042,987,211,259,831,760
97283,925,877,202,253,723,641
95042,739,748,193,246,546,514
93976,625,614,183,214,442,406
93596,643,576,187,198,456,381
88590,626,467,165,156,461,313
82246,606,408,125,119,481,290
76531,585,411,112,105,473,308
72628,614,420,95,95,519,333
70307,580,424,87,90,493,340
69262,546,418,85,97,461,327
69665,576,401,95,89,481,319
73068,586,335,95,64,491,282
77825,592,258,100,53,492,231
83838,612,223,90,37,522,214
89606,460,157,62,19,398,161
94683,293,90,47,14,246,96
99378,298,139,50,29,248,136
102837,364,215,53,41,311,191
105417,412,252,65,44,347,229
108016,442,319,70,45,372,292
109925,513,372,74,49,439,350
111096,615,384,69,43,546,384
112085,687,434,69,46,618,441
111924,721,504,68,55,653,510
109737,722,525,64,55,658,530
105791,495,386,53,43,442,387
102550,470,427,61,43,409,406
100814,608,525,89,68,519,487
93557,753,647,106,78,647,600
85171,804,663,112,83,692,609
78298,817,679,104,81,713,620
73582,922,769,112,102,810,687
70865,984,851,118,110,866,758
69264,958,846,102,92,856,770
69524,970,886,101,78,869,825
72808,956,920,105,79,851,859
77444,893,858,117,81,776,795
83028,809,746,100,60,709,704
88871,517,512,71,46,446,474
93603,261,249,60,41,201,217
98367,187,135,56,24,131,126
102337,198,121,64,26,134,103
105413,308,235,89,63,219,180
107886,468,424,99,88,369,340
109599,600,557,104,94,496,465
110704,711,586,119,93,592,499
111488,749,596,112,111,637,492
111364,764,610,122,125,642,499
109047,672,513,132,116,540,418
105369,503,360,114,88,389,291
103708,552,336,141,92,411,271
102271,726,456,184,123,542,373
95264,841,527,189,141,652,425
86841,896,533,197,130,699,440
79953,916,610,211,134,705,501
75391,911,707,219,162,692,563
72716,875,699,221,162,654,561
71091,895,633,214,149,681,513
71719,874,624,206,131,668,520
74725,709,556,163,96,546,492
80178,628,501,149,97,479,439
85930,615,437,120,86,495,389
91054,397,302,67,60,330,274
95599,273,187,54,55,219,164
99928,246,171,55,58,191,145
103553,313,258,65,59,248,230
105968,446,456,70,58,376,430
107822,611,659,72,55,539,638
108826,748,810,82,60,666,790
108932,813,902,83,54,730,878
108939,838,945,100,59,738,915
108520,798,864,105,67,693,822
106398,732,780,92,68,640,715
104022,605,600,82,67,523,535
103828,591,610,105,82,486,530
102704,760,812,144,102,616,712
96579,805,891,154,135,651,760
88654,745,781,159,142,586,645
82146,688,629,158,124,530,514
77748,756,619,165,125,591,501
74848,846,645,188,130,658,519
73519,882,631,186,118,696,518
73941,839,588,174,100,665,492
77535,799,478,161,84,638,402
83476,718,351,134,65,584,293
88768,624,320,99,57,525,270
93400,408,258,68,63,340,205
97308,229,192,60,65,169,136
101058,184,180,58,64,126,120
103843,279,337,61,64,218,281
106166,435,572,71,70,364,508
108510,544,660,76,52,468,614
110190,647,732,87,42,560,703
111128,687,717,99,30,588,701
112146,735,669,111,45,624,647
113105,757,556,118,51,639,524
109350,642,425,122,63,520,384
106462,514,287,118,72,396,238
104670,477,285,94,57,383,246
102896,517,408,91,66,426,371
96256,593,552,88,79,505,508
88046,675,657,88,88,587,595
81042,793,724,87,84,706,657
76408,946,799,103,82,843,743
73267,1016,857,110,84,906,809
71602,989,679,79,61,910,648
71773,898,475,78,65,820,448
74772,804,442,73,72,731,414
79296,815,551,68,57,747,522
85005,866,682,54,45,812,644
91184,852,768,36,37,816,735
96870,628,684,29,27,599,659
102179,557,651,43,45,514,612
106767,619,733,70,82,549,668
110090,726,885,89,99,637,798
113013,786,945,97,106,689,858
115273,898,1055,118,122,780,963
116701,945,1106,132,153,813,1008
117273,1075,1207,124,126,951,1119
115938,1137,1187,151,130,986,1095
112482,1125,1176,156,124,969,1095
108212,1018,1043,134,91,884,990
106202,1061,1021,165,99,896,944
104387,1194,1164,214,151,980,1033
97819,1303,1264,274,204,1029,1093
89752,1335,1337,297,229,1038,1147
82869,1229,1310,300,232,929,1133
77603,1104,1105,299,226,805,949
74152,981,829,312,257,669,683
71847,818,599,296,251,522,450
70876,739,558,275,251,464,374
71425,742,603,273,269,469,354
72830,689,623,247,259,442,366
75202,658,611,171,169,487,450
80686,580,530,147,144,433,404
86254,393,416,117,118,276,326
90686,300,350,89,92,211,272
94003,254,272,74,77,180,206
95978,277,236,80,67,197,173
96949,299,202,87,68,212,139
97591,407,296,101,80,306,231
98409,492,337,107,65,385,286
99075,556,309,120,36,436,282
99062,633,341,133,44,500,316
97917,637,361,120,44,517,330
95435,570,292,118,32,452,281
94030,561,245,141,46,420,226
93012,595,256,171,66,424,216
88015,662,279,193,76,469,229
81628,698,311,197,70,501,287
75703,706,302,198,71,508,272
71316,679,281,202,71,477,242
68166,619,244,190,65,429,219
66121,554,203,164,61,390,204
65097,469,131,142,40,327,114
64906,447,136,134,33,313,113
64713,462,126,139,35,323,102
66838,444,76,125,28,319,72
72393,362,48,112,38,250,31
78099,273,66,114,66,159,25
82715,290,139,142,93,148,64
86443,374,202,161,121,213,113
89321,489,287,166,126,323,203
91164,551,342,172,129,379,246
92600,600,379,168,121,432,305
94316,711,479,180,126,531,429
96372,761,560,209,147,552,501
97546,605,322,198,144,407,247
96252,498,221,174,133,324,140
93134,487,200,151,110,336,135
91795,545,262,159,110,386,173
90934,693,282,188,128,505,203
85409,771,344,195,127,576,278
78900,755,439,197,111,558,374
73253,747,453,201,95,546,382
69353,720,471,200,97,520,390
67104,804,448,202,103,602,362
66075,723,348,180,109,543,255
66719,740,388,172,123,568,275
69969,697,440,156,117,541,346
75026,699,535,155,121,544,451
80449,624,427,143,117,481,322
85961,440,347,101,97,339,251
90592,304,321,96,109,208,212
94668,309,310,97,94,212,217
97934,359,296,115,107,244,200
100328,463,334,121,116,342,255
102770,607,439,146,140,461,367
104206,631,443,153,142,478,373
105430,674,445,162,143,512,379
106289,676,403,168,132,508,361
105697,608,290,185,95,423,268
103015,615,180,225,109,390,186
99905,557,134,214,109,343,139
99619,501,120,193,107,308,134
97823,582,201,172,123,410,178
91311,734,350,180,152,554,286
83731,840,436,193,152,647,351
77365,915,471,170,127,745,389
73237,926,477,170,117,756,411
70702,848,446,162,116,686,388
69341,789,455,149,121,640,380
69935,678,442,119,101,559,384
73384,560,392,94,71,466,356
78993,552,392,89,74,463,354
84143,585,379,68,49,517,364
88643,442,293,47,32,395,295
92824,292,211,39,32,253,218
97141,247,201,37,23,210,218
100441,279,258,45,25,234,279
103169,332,279,72,50,260,309
105650,373,275,100,79,273,305
107216,414,297,128,114,286,313
108123,433,297,136,136,297,280
108981,417,273,143,142,274,220
109264,391,275,154,152,237,183
107474,384,254,147,137,237,174
105161,385,229,138,111,247,169
105052,446,257,151,120,295,167
103613,569,296,171,137,398,197
97188,625,357,167,130,458,251
89305,634,366,161,108,473,266
82405,640,399,147,99,493,316
77759,669,402,143,100,526,334
75015,699,373,142,95,557,318
73406,665,389,134,79,531,362
73942,650,368,133,76,517,345
77415,611,386,139,72,472,355
83666,633,380,146,74,487,344
89180,679,357,148,79,531,306
94482,556,282,112,74,444,249
99481,348,213,91,72,257,185
104786,294,175,90,66,204,142
109083,326,205,102,61,224,166
112715,370,264,102,66,268,244
115533,421,322,100,72,321,287
117626,488,330,118,86,370,286
118638,471,307,118,95,353,248
119614,453,274,120,104,333,212
119475,440,243,115,104,325,180
116951,422,224,114,112,308,148
113991,418,232,109,108,309,152
112835,458,251,118,104,340,187
110266,611,252,146,121,465,177
102909,872,218,162,136,710,161
94513,913,248,158,118,755,223
87219,917,295,151,100,766,302
82183,910,349,131,101,779,367
78769,860,345,125,114,735,368
77034,827,287,101,89,726,315
77317,802,308,77,69,725,317
80921,763,312,65,55,698,313
87074,714,284,63,55,651,273
93029,750,357,56,32,694,345
98773,587,381,33,18,554,371
104225,441,342,28,23,413,331
109848,403,313,28,17,375,305
114666,384,315,37,21,347,305
118402,361,286,31,19,330,281
122010,392,326,25,19,367,326
123580,407,320,26,27,381,331
124031,445,345,32,41,413,362
124229,432,318,35,46,397,331
122683,415,225,40,46,375,233
119194,408,173,55,67,353,183
115504,367,157,68,62,299,156
114649,422,195,84,60,338,167
112236,641,296,123,82,518,252
104766,793,385,136,70,657,342
96643,823,406,137,61,686,378
89587,829,450,131,47,698,419
84580,855,506,129,53,726,460
81386,770,474,136,69,634,418
79613,668,441,136,82,532,378
80111,697,399,138,84,559,366
83705,661,310,125,86,536,286
89618,647,332,124,87,523,316
95166,640,310,125,85,515,285
100927,504,219,103,73,401,183
106789,361,151,99,81,262,105
112546,376,178,107,103,269,145
117158,424,207,118,110,306,197
120725,519,249,113,99,406,278
123548,535,251,132,114,403,272
125440,515,262,150,141,365,287
126319,545,204,145,149,400,264
126585,468,116,126,138,342,152
125542,458,121,113,121,345,143
122344,521,199,120,106,401,213
117620,590,267,161,111,429,235
115223,634,336,191,118,443,276
112445,699,320,208,95,491,307
105501,807,369,224,88,583,370
97208,824,357,256,83,568,371
89562,802,343,242,78,560,350
84024,774,317,226,97,548,336
80321,747,292,199,120,548,334
77531,685,272,187,120,498,323
76044,585,207,181,108,404,246
76207,577,252,165,80,412,298
77077,538,242,153,71,385,285
79703,582,276,153,67,429,314
86041,520,310,148,67,372,338
92323,443,413,115,53,328,424
97898,453,500,110,58,343,527
101941,478,563,105,41,373,592
104784,589,719,111,41,478,743
106562,686,703,124,64,562,726
108090,748,673,134,74,614,682
109587,869,765,141,86,728,748
110855,902,759,142,100,760,728
110924,991,832,144,97,847,798
108752,994,861,139,109,855,822
104492,870,695,151,115,719,684
102714,739,515,172,110,567,510
100494,692,336,191,117,501,313
94498,690,244,198,107,492,214
87217,660,256,193,119,467,190
80795,598,266,184,140,414,176
75656,581,268,172,127,409,172
72366,593,300,167,113,426,211
70024,723,385,174,107,549,293
68737,842,469,175,109,667,379
68465,851,481,170,100,681,405
68752,881,498,150,87,731,452
70397,859,487,137,73,722,441
75969,772,431,137,78,635,369
82351,607,349,144,105,463,264
88127,640,398,139,120,501,317
93253,765,451,173,161,592,381
97872,798,442,176,172,622,368
101709,820,417,188,177,632,326
104907,839,427,205,167,634,340
107824,911,477,234,165,677,373
110428,1048,575,237,181,811,511
111446,1193,697,243,192,950,642
109832,1168,668,248,190,920,559
107016,998,657,249,192,749,486
106247,942,633,260,193,682,451
104250,1080,690,267,220,813,482
97864,1191,775,279,238,912,579
90249,1273,751,287,228,986,590
83690,1399,838,296,230,1103,694
79135,1391,812,301,226,1090,675
76242,1358,763,295,225,1063,626
74827,1338,692,310,236,1028,532
75291,1329,727,316,230,1013,549
79056,1197,691,316,224,881,511
85263,1186,682,304,222,882,507
91058,1225,731,283,221,942,544
97498,1160,855,278,213,882,670
103586,1019,975,262,186,757,810
109984,1003,965,227,172,776,809
115168,1000,971,225,159,775,826
119392,969,1000,203,144,766,866
123239,913,958,196,141,717,824
125836,903,923,195,152,708,776
127331,875,840,202,152,673,696
128069,908,778,210,160,698,634
127635,815,652,220,191,595,472
124700,740,605,213,195,527,424
120473,620,430,186,156,434,291
118811,531,331,171,118,360,227
115411,617,290,197,121,420,210
106535,744,290,203,100,541,240
97375,907,419,195,118,712,354
89583,892,441,198,142,694,331
84256,850,443,210,160,640,303
80871,870,435,216,119,654,334
79044,876,430,197,73,679,360
79297,898,423,184,68,714,358
82963,852,431,180,87,672,348
89187,913,436,173,78,740,367
93818,1030,537,163,83,867,460
98031,964,489,115,69,849,440
101355,850,500,119,98,731,462
104647,851,516,140,107,711,487
107559,837,486,136,106,701,430
110011,848,508,141,102,707,418
112583,867,546,152,143,715,428
114715,964,614,167,167,797,486
116203,1043,658,205,176,838,501
117162,1092,694,224,198,868,512
116277,1107,666,239,199,868,478
112505,1075,664,266,217,809,458
108289,1005,612,274,212,731,427
107028,962,476,320,213,642,274
103953,1107,546,363,230,744,320
96065,1178,593,367,234,811,376
87635,1071,516,323,210,748,358
80632,1012,472,301,175,711,379
75548,927,452,292,164,635,364
72201,882,412,280,152,602,326
70204,855,338,277,152,578,258
69810,873,341,290,165,583,260
72681,970,342,317,183,653,269
77516,1002,392,330,196,672,298
81783,1010,409,300,182,710,327
85835,885,366,264,175,621,298
88935,712,340,236,184,476,229
91665,596,312,219,172,377,186
93500,541,273,212,144,329,159
94837,540,262,214,141,326,151
96107,546,280,229,162,317,140
97002,545,280,230,165,315,136
97409,545,302,222,159,323,177
97736,593,327,233,155,360,203
97656,563,294,208,147,355,186
95691,559,292,190,145,369,196
92824,505,254,178,121,327,168
92895,451,241,180,114,271,142
91701,525,270,187,101,338,196
85004,611,345,201,87,410,306
77333,666,408,187,82,479,371
71883,707,446,170,98,537,402
68302,623,423,150,78,473,387
66191,489,240,131,64,358,215
65149,436,250,144,89,292,185
65675,456,302,148,119,308,206
69148,529,379,158,154,371,243
74424,516,396,155,165,361,246
78790,513,354,149,174,364,184
83241,474,250,100,129,374,128
87030,305,214,83,123,222,101
90302,239,226,87,138,152,113
92587,259,231,83,142,176,162
94351,291,252,65,109,226,232
96060,360,377,54,84,306,383
96888,437,504,58,73,379,507
97911,449,528,65,62,384,520
98948,429,463,54,61,375,477
99068,436,463,50,48,386,482
97161,423,454,47,39,376,469
94331,466,622,44,33,422,630
94401,475,574,66,40,409,574
92804,590,624,78,52,512,623
86292,801,805,98,59,703,790
78906,870,822,105,72,765,793
73099,867,795,110,83,757,755
69239,936,834,105,80,831,785
66720,1068,899,105,82,963,847
65443,1115,904,106,82,1009,855
66185,1125,938,96,71,1029,898
69169,953,786,91,81,862,727
74291,873,743,98,100,775,671
78722,902,660,92,94,810,613
83728,832,603,65,84,767,576
88174,670,593,60,105,610,559
92393,606,578,73,124,533,536
95065,502,419,80,110,422,363
97327,514,397,90,105,424,343
99494,689,633,103,101,586,604
100830,646,535,120,126,526,498
101451,654,500,131,155,523,471
101724,624,328,137,164,487,299
101113,696,403,161,196,535,378
98532,596,345,160,208,436,307
95227,466,283,172,228,294,143
94339,558,326,201,237,357,176
92382,753,370,237,231,516,220
86351,882,376,271,214,611,269
79405,1055,471,301,212,754,340
73234,1110,483,303,199,807,351
68953,1201,466,314,199,887,381
66273,1219,468,312,205,907,381
64517,1167,460,292,215,875,351
64156,1125,481,267,210,858,366
65028,1025,465,249,196,776,346
66369,954,381,237,176,717,270
68552,939,338,221,162,718,243
73666,759,276,186,148,573,185
78937,473,256,146,122,327,143
83332,377,236,125,93,252,153
86654,365,249,116,87,249,168
89082,370,251,104,88,266,174
90926,372,234,98,97,274,143
92181,413,181,94,100,319,99
93768,368,115,86,89,282,60
94835,391,76,91,85,300,91
95058,451,182,84,72,367,221
93563,452,216,60,50,392,246
91371,400,137,40,28,360,153
91418,351,54,41,18,310,60
89886,453,138,55,26,398,117
84915,557,169,76,44,481,144
78764,610,243,90,47,520,206
73243,610,262,103,50,507,219
68972,577,242,107,51,470,197
66355,562,273,97,42,465,250
64759,551,365,82,44,469,347
63959,465,305,80,33,385,280
64260,445,278,88,34,357,247
64973,404,232,93,44,311,211
66099,362,200,74,32,288,183
70464,300,135,60,37,240,121
75462,226,122,58,54,168,106
79520,247,171,56,59,191,174
82901,257,224,59,46,198,228
85343,309,310,69,50,240,282
87067,370,389,85,69,285,326
88371,434,506,86,77,348,430
89484,452,538,91,91,361,449
90630,492,551,89,95,403,458
91704,520,557,95,103,425,459
91575,575,634,92,101,483,543
91062,520,634,78,76,442,578
92475,556,647,75,54,481,605
91076,655,651,82,52,573,607
85597,649,696,84,60,565,643
79330,673,615,80,64,593,557
73928,720,674,76,65,644,616
70170,705,635,74,64,631,584
68073,722,698,69,61,653,643
67148,684,617,69,56,615,565
68131,725,620,69,48,656,574
72070,832,685,80,47,752,642
78926,1033,920,75,44,958,884
84035,1009,868,73,46,936,835
88911,848,692,54,39,794,667
93197,644,598,56,44,588,567
97510,635,621,63,53,572,582
100856,718,757,65,68,653,701
103958,796,858,76,88,720,783
106637,755,847,67,88,688,765
108111,690,771,56,83,634,692
109557,678,642,55,75,623,572
110467,678,581,61,74,617,513
110595,708,502,74,80,634,442
109031,726,555,101,105,625,479
106566,669,464,125,135,544,360
106935,705,454,144,151,561,322
104058,690,418,152,145,538,318
96113,725,484,175,155,550,356
87325,763,569,187,161,576,438
80303,801,561,193,162,608,451
75502,878,571,185,145,693,480
72727,859,590,164,141,695,477
71280,790,552,147,133,643,430
71467,786,517,116,106,670,421
75077,729,470,99,94,630,392
81375,759,545,105,100,654,472
86468,847,744,102,99,745,655
92059,797,804,81,99,716,720
98069,746,841,77,108,669,756
104730,914,1141,78,118,836,1042
110777,1116,1276,87,118,1029,1180
115530,1275,1375,103,124,1172,1263
120025,1464,1508,134,137,1330,1375
123314,1545,1520,166,169,1379,1355
125716,1577,1505,200,187,1377,1323
127481,1579,1449,206,181,1373,1275
127891,1517,1256,179,144,1338,1114
124854,1392,1066,148,126,1244,941
120443,1060,764,139,134,921,632
119068,835,716,156,150,679,575
114469,791,717,163,148,628,578
105259,824,617,171,164,653,467
95459,921,629,202,176,719,484
87150,1038,675,214,185,824,520
81467,1041,698,213,176,828,565
77779,991,672,204,163,787,562
75805,979,663,205,163,774,556
75601,1009,635,192,152,817,536
78982,981,588,172,142,809,493
85679,849,501,148,125,701,409
90885,793,521,134,129,659,413
96471,632,479,104,125,528,365
102781,481,479,92,121,389,362
110066,433,508,91,130,342,385
116391,455,576,89,137,366,442
121901,522,609,93,144,429,467
126369,600,631,93,128,507,505
129937,647,648,88,104,559,547
132044,703,677,102,113,601,572
133450,750,646,111,114,639,545
132645,750,634,121,129,629,515
129090,692,532,123,117,569,429
124737,634,425,124,102,510,333
123333,642,331,136,109,506,253
118639,702,313,135,99,567,266
109547,865,339,156,141,709,283
99523,894,292,148,118,746,268
91514,918,355,158,101,760,328
85906,983,404,184,121,799,354
82250,968,396,190,131,778,338
79873,886,349,170,121,716,294
80010,815,297,143,122,672,259
83647,848,337,140,138,708,330
90935,724,275,127,133,597,239
96345,658,282,112,121,546,247
101471,573,256,93,109,480,239
106399,498,289,85,103,413,279
110990,455,329,74,89,381,324
115578,557,307,66,95,491,338
119138,498,358,70,106,428,376
122079,594,407,91,112,503,422
123300,641,493,100,114,541,492
123457,572,426,113,117,459,420
123568,551,459,137,137,414,409
122709,478,386,132,130,346,345
119445,403,330,105,103,298,291
116281,382,321,112,128,270,262
115893,416,332,120,127,296,283
111913,466,325,111,100,355,276
103452,568,287,108,77,460,263
94411,655,261,103,62,552,288
86851,757,308,102,65,655,357
81535,838,393,97,67,741,449
78259,785,393,81,61,704,437
76462,668,357,68,54,600,395
76606,608,359,65,48,543,390
80101,515,353,57,42,458,372
86706,569,402,52,45,517,416
91933,635,517,53,49,582,523
96620,671,543,42,43,629,557
101147,472,443,37,42,435,453
105223,376,394,42,51,334,405
108321,474,417,49,61,425,440
110446,672,581,55,69,617,615
112429,781,569,50,62,731,590
113485,842,650,44,50,798,674
113718,902,608,50,52,852,634
113524,932,710,42,46,890,734
112199,910,734,41,49,869,762
108859,853,655,49,55,804,681
104658,796,588,56,56,740,611
102819,832,418,69,65,763,450
99395,1049,372,71,61,978,404
92514,1154,352,81,50,1073,380
84385,1194,404,94,49,1100,428
77550,1287,439,103,61,1184,461
72734,1320,479,108,62,1212,491
70286,1328,484,122,71,1206,504
67406,1246,463,125,79,1121,452
66447,1351,624,129,91,1222,588
66950,1314,635,128,96,1186,598
68373,1349,710,127,93,1222,649
70806,1277,721,115,89,1162,653
76519,1031,573,76,60,955,542
82501,694,394,49,45,645,395
87910,572,446,38,42,534,443
92054,729,686,34,36,695,678
95561,999,1104,49,43,950,1078
98482,1079,1207,59,49,1020,1171
100821,1250,1342,60,50,1190,1301
103116,1319,1403,59,63,1260,1345
105375,1252,1336,60,58,1192,1279
105764,1231,1300,59,51,1172,1251
103715,1093,1115,53,39,1040,1078
99538,931,880,64,40,867,845
97937,842,590,85,59,757,550
94658,925,388,111,75,814,368
88244,1092,305,136,86,956,316
81178,1222,268,155,86,1067,288
74842,1237,226,180,89,1057,254
70224,1165,270,172,89,993,296
67050,1043,303,166,113,877,260
65178,1053,410,160,144,893,296
64175,1091,463,160,147,931,330
64205,1086,337,147,159,939,220
64546,989,338,131,151,858,257
65949,995,393,123,134,872,319
71448,946,450,98,114,848,382
77618,639,353,84,104,555,278
83377,568,439,97,95,471,354
88746,636,490,106,86,530,408
93483,718,516,85,63,633,460
97763,802,432,75,49,727,385
101472,776,406,78,39,698,368
105006,759,393,73,38,686,356
108052,763,380,76,48,687,336
109620,808,274,78,49,730,242
108352,745,159,78,39,667,148
104865,684,153,95,36,589,185
104452,765,254,134,39,631,276
100935,944,299,165,45,779,300
93084,1219,474,210,79,1009,465
85107,1328,477,267,107,1061,455
78423,1375,486,283,99,1092,450
74169,1366,512,268,80,1098,486
71568,1373,652,265,115,1108,571
70467,1353,741,257,143,1096,622
70839,1325,756,252,131,1073,647
75195,1284,750,267,137,1017,638
82478,1262,726,279,133,983,615
87302,1174,698,251,151,923,560
92328,1003,560,222,158,781,408
97327,725,357,209,146,516,218
102848,644,241,167,112,477,175
108859,612,185,130,67,482,188
114642,509,178,126,52,383,165
119890,398,175,114,50,284,156
123995,391,180,98,45,293,178
126965,339,137,94,43,245,110
128973,410,197,102,54,308,152
129087,458,337,110,66,348,274
126432,489,348,128,88,361,273
123026,524,377,168,120,356,269
122619,617,521,212,159,405,371
117550,755,720,236,216,519,516
107907,779,729,246,224,533,522
98024,842,841,255,220,587,641
90325,904,940,269,221,635,740
85743,920,1026,253,227,667,811
81763,903,951,234,185,669,781
79892,897,862,228,174,669,707
80055,937,814,233,173,704,673
83927,950,733,215,152,735,632
92127,869,617,189,126,680,545
97674,870,545,185,107,685,493
102594,699,456,134,75,565,404
108183,443,350,107,61,336,297
114618,344,255,79,46,265,217
119981,331,242,55,25,276,221
124549,352,297,56,21,296,283
129307,459,388,60,22,399,371
132851,495,414,65,26,430,404
135548,528,424,55,23,473,432
137522,575,444,56,29,519,447
137625,642,535,59,32,583,518
134678,620,547,69,46,551,515
131190,649,574,105,71,544,513
130672,801,687,127,78,674,622
125226,1010,854,142,75,868,795
115269,1113,914,153,78,960,864
104794,1171,862,173,91,998,840
96509,1188,872,203,110,985,892
90765,1161,876,207,132,954,931
87073,1204,845,213,139,991,899
84692,1186,778,223,138,963,818
84810,1098,639,218,152,880,699
88649,993,572,196,165,797,645
96644,937,585,183,147,754,632
102093,996,636,191,122,805,666
106197,805,518,158,100,647,526
110808,546,392,140,122,406,389
114789,433,368,134,135,299,348
118246,365,299,138,145,227,257
120498,358,286,158,157,200,198
121862,345,246,153,144,192,163
122977,409,211,159,147,250,148
122790,471,207,166,144,305,164
123264,530,206,164,150,366,164
123013,607,197,161,149,446,208
120721,538,190,151,128,387,195
118812,540,194,132,107,408,199
118556,627,260,159,126,468,271
114266,769,293,168,131,601,292
105820,911,372,152,99,759,345
96474,933,415,114,55,819,393
89151,840,339,108,53,732,306
84014,804,296,104,53,700,261
80977,744,296,98,55,646,255
79308,675,266,96,53,579,229
79704,608,330,78,38,530,308
83805,551,376,69,37,482,356
92144,577,377,68,37,509,353
97433,676,417,71,41,605,386
101661,670,442,52,37,618,425
105564,417,318,38,28,379,308
110342,343,312,42,31,301,294
114300,328,362,45,36,283,344
118407,235,257,34,34,201,246
123504,171,169,26,20,145,166
126299,147,129,29,20,118,133
129043,156,114,34,26,122,120
130983,187,135,38,27,149,143
130712,221,168,44,27,177,170
127473,249,248,48,26,201,239
122886,309,334,66,46,243,293
121512,447,534,96,81,351,457
116258,563,665,112,116,451,550
106374,723,800,130,153,593,651
96256,826,858,144,187,682,682
88043,860,870,152,212,708,675
82402,918,940,148,211,770,751
78941,942,953,145,191,797,791
76851,964,966,146,192,818,806
76928,929,793,141,183,788,654
80521,901,756,136,160,765,641
87895,1007,672,138,158,869,572
92830,1053,554,143,159,910,464
98305,979,592,121,137,858,489
104393,681,704,78,111,603,599
111069,562,781,54,86,508,697
117089,600,824,47,66,553,761
122307,582,840,49,62,533,781
127173,603,875,52,66,551,812
131121,582,797,53,65,529,735
133817,609,767,57,73,552,696
135416,593,654,56,64,537,594
134733,597,594,66,72,531,527
129621,584,507,91,101,493,413
122502,636,578,134,141,502,443
119931,692,537,179,155,513,398
114493,891,579,196,153,695,471
106212,1020,691,217,147,803,585
97390,1029,765,241,149,788,663
89352,959,723,247,140,712,622
83797,993,708,250,125,743,618
79749,1015,794,259,106,756,734
77186,1044,797,290,96,754,735
75787,1046,777,294,89,752,710
76066,1056,846,279,89,777,774
77618,1068,923,281,105,787,836
80085,1022,852,266,105,756,759
86332,841,690,217,96,624,603
93726,557,459,164,98,393,367
100752,503,436,159,113,344,334
106834,489,488,154,114,335,385
111586,499,496,161,129,338,374
115163,552,400,162,130,390,283
117597,589,285,159,112,430,237
119094,704,306,154,96,550,314
119219,788,317,147,101,641,342
117061,786,400,144,98,642,432
113443,645,410,126,88,519,439
110664,583,384,129,113,454,405
110535,708,386,178,160,530,405
106824,926,324,204,185,722,372
100401,1135,329,218,189,917,413
93156,1250,347,205,176,1045,403
86204,1256,426,194,150,1062,454
81170,1237,419,168,120,1069,446
77448,1190,398,142,88,1048,424
74706,1175,437,130,82,1045,452
73141,1177,447,126,110,1051,458
73033,1154,453,121,104,1033,452
73752,1051,435,99,71,952,417
75305,1086,484,78,44,1008,474
81360,1113,665,57,33,1056,665
88854,971,774,38,29,933,773
95853,904,726,34,22,870,722
102208,957,624,53,28,904,615
107743,961,666,70,50,891,631
111844,1073,696,82,62,991,645
114557,1150,750,94,78,1056,686
116700,1232,810,99,86,1133,737
118009,1310,837,95,89,1215,761
117430,1309,828,90,89,1219,753
114640,1191,708,85,82,1106,644
111288,1119,615,104,94,1015,552
110266,1236,528,124,103,1112,457
106569,1524,382,131,102,1393,326
100176,1643,287,140,108,1503,284
92745,1693,253,184,138,1509,201
85944,1682,286,187,160,1495,184
80629,1580,210,192,174,1388,165
76876,1486,281,182,192,1304,212
74722,1415,360,187,204,1228,232
73988,1194,284,178,184,1016,168
74894,1151,223,159,160,992,133
76710,1121,149,149,147,972,164
77903,1095,126,144,131,951,183
82943,996,53,113,86,883,125
90369,716,155,92,81,624,138
97565,644,249,79,68,565,228
103422,643,276,81,64,562,265
107612,730,328,79,51,651,331
110706,887,395,98,52,789,432
112407,980,282,114,74,866,349
113773,1044,163,131,87,913,241
115716,1067,168,167,152,900,189
116054,1015,268,176,183,839,208
113466,963,275,173,196,790,201
110802,895,267,185,196,710,239
110397,935,316,179,126,756,320
105359,1217,433,176,103,1041,467
96809,1318,481,186,79,1132,511
88299,1322,530,201,76,1121,552
81813,1337,542,211,55,1126,545
77138,1194,553,220,67,974,554
74562,1098,549,188,58,910,548
73119,962,519,183,60,779,525
73568,871,435,189,100,682,456
77745,841,381,167,71,674,398
86150,769,324,179,63,590,345
91311,749,344,177,59,572,372
95577,660,319,147,64,513,361
99755,427,174,131,95,296,179
103902,351,181,140,132,211,108
106910,376,197,136,127,240,139
109285,437,246,133,130,304,212
111627,411,270,122,127,289,225
112962,412,249,107,118,305,205
113803,424,205,98,106,326,177
114421,437,205,101,116,336,176
113351,448,184,112,129,336,159
109852,427,193,120,132,307,152
106556,358,155,111,104,247,163
106432,426,209,113,97,313,240
100823,595,357,130,90,465,382
91919,755,565,125,79,630,579
83120,901,669,129,90,772,687
76282,973,719,141,114,832,749
72141,964,754,143,122,821,781
69488,897,700,134,119,763,719
67957,855,718,119,114,736,732
68481,835,742,112,114,723,742
72601,792,797,108,116,684,790
80294,751,832,98,117,653,826
84489,670,629,95,106,575,623
88048,583,446,82,87,501,435
91671,371,316,76,76,295,297
95614,278,345,63,63,215,331
98763,256,307,48,51,208,298
101753,324,314,42,40,282,317
105103,447,397,44,36,403,403
108339,467,405,50,37,417,412
110979,568,495,65,41,503,503
113350,691,745,77,48,614,763
113886,785,898,85,58,700,921
111228,736,724,89,62,647,745
107872,726,650,130,88,596,671
107498,887,603,181,138,706,624
102353,1141,673,230,182,911,693
93582,1337,668,254,186,1083,723
84813,1410,654,271,178,1139,749
77948,1697,534,291,186,1406,675
73544,1764,615,301,185,1463,739
71080,1760,676,286,190,1474,777
69779,1768,589,255,190,1513,695
70171,1616,632,224,194,1392,720
74365,1499,605,202,197,1297,669
81931,1332,601,178,184,1154,655
86724,1211,443,158,165,1053,495
90738,1152,388,135,143,1017,441
94703,924,83,90,112,834,164
98531,824,81,74,107,750,112
101934,688,212,88,146,600,161
104746,710,271,102,165,608,216
107435,702,329,102,161,600,295
109249,798,308,112,154,686,300
110386,896,380,109,130,787,388
110929,1013,555,110,114,903,560
110058,1073,736,118,95,955,725
106759,998,676,118,93,880,645
103473,935,612,136,91,799,553
103292,947,450,167,99,780,374
97913,1161,562,188,112,973,493
89410,1384,633,209,120,1175,547
81050,1380,793,234,131,1146,703
74829,1465,830,276,160,1189,724
70640,1477,773,280,182,1197,659
67957,1414,759,265,187,1149,660
66625,1355,723,267,191,1088,594
66997,1282,662,242,171,1040,519
70804,1207,657,190,139,1017,528
78082,1190,690,165,145,1025,550
81698,1109,758,150,150,959,613
84880,1013,695,120,116,893,597
88235,653,611,84,92,569,537
90979,495,622,78,92,417,558
93426,523,655,80,100,443,573
95338,539,586,73,92,466,508
97673,565,562,84,102,481,474
99463,625,612,97,122,528,500
100883,740,723,110,133,630,596
102210,816,867,127,140,689,742
102057,863,897,154,157,709,801
99149,803,850,131,130,672,781
95985,715,647,129,112,586,587
95643,862,727,151,106,711,683
91695,1011,800,147,110,864,744
85546,1093,749,160,115,933,708
78355,1270,687,195,113,1075,686
72586,1418,657,211,117,1207,695
68688,1486,703,194,116,1292,774
66124,1516,699,197,131,1319,792
64542,1514,796,188,82,1326,850
63819,1516,905,167,65,1349,925
64846,1361,886,167,67,1194,892
66633,1223,829,165,73,1058,831
68911,1105,754,153,74,952,755
73650,986,641,121,56,865,620
78530,760,467,75,41,685,463
82494,665,503,46,37,619,502
86014,526,397,33,34,493,385
89054,607,409,26,25,581,409
91601,709,498,22,21,687,490
93950,765,669,46,49,719,629
95872,787,875,63,61,724,820
97660,896,1073,59,40,837,1042
98058,903,1179,58,32,845,1156
96669,1003,1149,72,45,931,1115
95449,981,1043,100,49,881,1005
95916,1127,982,153,76,974,934
92742,1196,996,176,89,1020,950
87098,1388,1037,207,83,1181,1000
80918,1503,926,242,96,1261,893
75297,1527,787,267,92,1260,771
71275,1650,747,311,112,1339,711
68547,1654,785,328,114,1326,740
66729,1548,651,309,106,1239,629
65951,1447,468,299,112,1148,447
65945,1401,419,315,130,1086,373
67325,1351,383,306,135,1045,347
68914,1385,328,292,127,1093,339
73783,1215,275,241,111,974,278
79968,1028,266,221,127,807,248
85647,1124,410,225,150,899,411
90936,1354,643,216,144,1138,660
95858,1336,607,243,159,1093,612
99284,1265,526,247,122,1018,565
101708,1297,455,275,114,1022,520
103383,1275,448,315,132,960,414
105117,1260,481,303,121,957,413
105921,1224,488,285,110,939,422
103914,1075,527,258,113,817,450
102284,1035,307,267,98,768,274
102859,1191,228,322,114,869,197
97524,1343,189,329,118,1014,128
89849,1325,306,334,129,991,241
82223,1357,372,354,148,1003,295
75758,1269,386,332,130,937,306
71821,1112,327,313,104,799,254
69557,1083,232,318,107,765,188
68409,1117,225,329,106,788,206
68983,1100,226,273,61,827,250
73390,1076,247,237,52,839,250
81980,933,145,231,57,702,128
87179,959,314,231,103,728,227
90290,862,303,175,101,687,213
94088,750,382,127,105,623,328
98837,679,399,118,104,561,345
103018,674,310,124,104,550,257
107195,761,397,95,69,666,364
111203,729,375,84,52,645,352
114072,663,362,100,53,563,317
116445,624,388,128,62,496,330
118611,687,411,140,60,547,358
119166,779,474,165,82,614,419
117277,833,427,181,109,652,358
116388,904,411,201,119,703,349
116732,1026,592,211,115,815,497
111657,1101,710,201,149,900,578
102874,1214,745,196,162,1018,603
94370,1192,762,192,156,1000,621
87329,1188,821,184,143,1004,690
82756,1212,890,193,141,1019,757
79749,1215,928,194,143,1021,795
78242,1298,933,200,157,1098,807
78542,1332,876,208,143,1124,778
82886,1412,914,219,132,1193,860
92297,1455,946,248,123,1207,918
97930,1428,879,249,125,1179,859
102029,1389,930,213,105,1176,915
107583,1337,1051,166,78,1171,1063
114503,1306,1170,180,69,1126,1210
121220,1403,1196,182,39,1221,1220
127624,1493,1184,204,50,1289,1171
134028,1736,1175,224,58,1512,1161
138473,1881,1117,226,67,1655,1119
141477,1970,1193,224,64,1746,1196
143461,1990,1146,218,56,1772,1144
143267,1967,1210,215,58,1752,1201
139684,1704,1202,209,63,1495,1170
136608,1494,1049,250,75,1244,984
135868,1539,998,317,118,1222,885
128343,1706,1049,340,139,1366,912
117702,1806,1068,350,174,1456,901
107174,1882,922,350,188,1532,751
98830,1844,880,321,196,1523,721
92807,1737,874,335,230,1402,689
88606,1613,782,314,222,1299,617
86343,1501,697,299,203,1202,540
85671,1404,585,331,215,1073,477
89564,1398,543,334,203,1064,514
98150,1338,501,335,211,1003,488
103381,1321,516,315,201,1006,541
108165,1291,578,302,253,989,542
114530,990,515,285,281,705,376
122143,836,485,244,261,592,349
129483,897,499,226,241,671,475
136069,898,477,180,197,718,496
140216,909,331,161,169,748,394
141477,943,279,140,135,803,367
140507,931,299,143,129,788,355
140387,965,335,147,123,818,364
138839,992,357,150,131,842,374
136117,971,378,132,131,839,399
133911,848,338,117,124,731,344
132880,883,415,105,116,778,448
125724,975,569,105,122,870,608
114945,1047,583,109,101,938,637
104324,1150,572,114,80,1036,624
95700,1271,549,137,79,1134,602
89929,1286,586,187,112,1099,671
85905,1262,574,217,124,1045,669
83700,1293,489,225,122,1068,575
83458,1190,361,220,134,970,468
87421,1074,291,197,136,877,399
96011,942,181,163,119,779,262
101086,900,129,149,103,751,179
104428,834,108,130,93,704,169
108785,617,141,100,76,517,110
113672,522,225,73,56,449,200
119281,661,242,62,52,599,232
122638,827,237,62,52,765,213
124356,918,422,92,102,826,343
125452,1071,614,125,137,946,501
125527,1186,746,145,148,1041,613
124513,1509,949,153,157,1356,797
122149,1687,966,137,122,1550,849
116711,1665,844,122,76,1543,782
113410,1448,652,157,65,1291,610
111851,1456,494,199,47,1257,494
105605,1579,474,224,33,1355,470
97380,1624,409,230,45,1394,430
89210,1675,434,243,82,1432,456
81619,1664,542,270,107,1394,563
77128,1711,557,300,120,1411,583
74266,1671,521,310,107,1361,530
72794,1579,527,295,98,1284,502
72722,1521,453,308,128,1213,392
76314,1388,370,319,156,1069,270
84062,1303,301,321,173,982,176
88180,1269,314,293,142,976,205
90365,1229,238,265,121,964,151
92658,997,252,256,140,741,128
94832,964,429,265,162,699,285
96270,966,511,295,202,671,321
96993,861,465,301,208,560,262
97703,839,386,289,190,550,201
97914,863,293,273,184,590,131
97677,922,257,244,156,678,173
97097,1041,374,265,170,776,310
95215,1066,389,261,172,805,335
91350,987,422,269,164,718,355
89758,931,416,288,151,643,363
89896,977,388,311,132,666,347
85992,1090,454,332,146,758,365
80453,1172,550,320,162,852,430
74051,1243,682,293,157,950,550
68653,1226,734,295,154,931,600
65037,1118,758,300,172,818,619
62819,1016,769,295,167,721,635
61328,1039,883,313,192,726,722
61164,1177,1099,328,221,849,907
62318,1186,1044,317,205,869,879
64544,1125,984,308,186,817,836
66724,1083,1100,301,189,782,935
70702,1036,1033,277,194,759,857
74156,787,854,228,205,559,668
76241,729,918,217,240,512,698
77328,797,1043,207,256,590,808
77566,744,1049,180,213,564,850
77704,708,1050,143,149,565,911
77684,736,1082,147,135,589,959
77851,782,1069,153,129,629,950
78430,803,1035,155,123,648,920
78654,830,994,159,117,671,900
78103,740,890,122,88,618,837
78785,684,735,143,96,541,710
80176,825,806,155,104,670,767
77610,1041,943,171,119,870,878
73085,1163,923,190,140,973,870
68168,1223,776,178,127,1045,731
63984,1219,767,177,122,1042,700
61137,1208,763,179,132,1029,700
59418,1326,889,167,124,1159,837
58343,1274,856,162,125,1112,805
57965,1176,761,147,113,1029,717
58578,1089,638,144,105,945,592
59986,1008,536,150,102,858,491
61637,914,480,143,92,771,451
65622,817,447,118,80,699,437
68989,563,297,80,68,483,314
71509,491,188,64,82,427,238
73078,572,283,65,99,507,344
74523,569,278,60,93,509,336
75478,582,257,61,96,521,321
76405,543,375,58,87,485,413
77391,545,454,58,73,487,483
79034,506,496,58,54,448,526
80632,507,523,46,38,461,549
81038,559,432,50,26,509,455
83568,621,326,64,25,557,340
85060,922,530,85,40,837,547
81454,1170,692,101,59,1069,700
75941,1260,764,123,79,1137,751
70740,1303,779,133,87,1170,746
66677,1324,752,138,102,1186,704
64028,1340,664,141,119,1199,611
62927,1302,594,144,129,1158,547
62638,1281,580,137,126,1144,552
63794,1315,614,129,132,1186,566
68350,1248,618,110,124,1138,576
77310,1134,664,118,135,1016,621
83013,1004,631,126,138,878,573
85535,870,591,103,114,767,536
87628,649,509,94,101,555,444
89605,577,495,99,91,478,425
90575,727,575,95,72,632,539
91204,846,675,78,53,768,666
91763,840,693,82,65,758,669
91797,959,927,95,83,864,876
91411,948,857,100,88,848,808
91123,915,799,106,98,809,746
90866,883,766,120,122,763,703
89734,755,607,126,130,629,554
90872,691,519,149,143,542,439
92092,936,680,183,172,753,569
87282,1201,864,200,196,1001,741
80425,1311,989,198,202,1113,878
73638,1205,945,196,216,1009,852
68641,1158,890,202,215,956,837
65536,1072,826,189,203,883,780
63876,951,733,175,195,776,693
63020,803,666,162,182,641,653
63884,828,530,160,184,668,532
68238,783,498,153,183,630,517
76455,752,457,153,195,599,472
80841,785,492,150,189,635,493
82467,826,556,125,157,701,544
83866,611,460,96,124,515,440
85288,540,465,86,108,454,451
86483,607,620,88,110,519,631
87337,693,743,73,95,620,749
88281,717,711,73,95,644,702
88865,752,697,78,99,674,670
89059,773,666,79,88,694,627
89417,768,614,78,91,690,561
89160,821,628,96,112,725,571
87815,841,630,124,133,717,576
89233,858,566,167,157,691,536
90707,1050,636,209,186,841,636
86266,1329,797,236,195,1093,800
79424,1440,872,235,187,1205,873
72844,1492,887,244,177,1248,889
67924,1516,921,245,166,1271,910
65103,1509,894,230,138,1279,868
63593,1432,786,230,131,1202,741
62984,1405,804,221,126,1184,774
63823,1364,831,223,137,1141,820
68220,1199,809,215,138,984,757
76782,1143,912,217,171,926,794
81508,1048,927,205,193,843,761
83528,907,711,172,196,735,566
85050,777,723,137,211,640,574
86638,710,725,96,147,614,610
88023,798,747,106,164,692,611
89071,803,651,106,153,697,520
90445,810,621,106,140,704,500
91210,803,604,96,115,707,505
91429,736,562,94,93,642,478
92003,760,567,88,67,672,504
91806,787,533,101,84,686,457
90921,725,510,136,154,589,366
92388,717,496,191,179,526,330
93272,855,484,201,131,654,387
89069,1071,526,234,126,837,478
82347,1126,395,257,134,869,366
75440,1156,429,268,109,888,435
70615,1060,443,235,80,825,447
67307,1008,565,190,87,818,543
65424,1113,804,169,92,944,780
64857,1121,838,165,99,956,803
65925,1145,908,170,98,975,860
70305,1158,869,159,92,999,820
79165,1159,818,154,104,1005,755
84213,1298,855,157,109,1141,795
86774,1418,834,149,118,1269,782
88873,1165,677,133,133,1032,649
91226,1090,685,111,114,979,663
92739,1289,576,110,108,1179,522
93947,1426,392,106,94,1320,328
95619,1396,380,84,72,1312,325
97187,1395,340,81,70,1314,283
98195,1462,311,92,89,1370,269
99278,1547,281,103,118,1444,246
99357,1549,286,105,126,1444,239
97781,1472,290,126,144,1346,267
99047,1410,236,171,182,1239,265
99554,1668,279,223,235,1445,293
94830,1979,425,265,284,1714,351
87348,2029,654,291,307,1738,513
79955,2115,763,287,286,1828,653
74162,2106,832,277,266,1829,707
70388,2030,854,276,242,1754,750
68065,1833,891,300,236,1533,761
66754,1686,971,297,227,1389,819
67368,1546,988,309,234,1237,812
71618,1484,993,310,223,1174,824
79971,1403,903,300,220,1103,753
85027,1324,827,285,205,1039,694
87832,1207,791,231,167,976,684
90877,906,674,189,147,717,597
93936,819,645,169,123,650,572
96675,861,717,155,103,706,646
99277,919,845,134,90,785,785
101381,952,892,130,89,822,830
102830,982,937,126,84,856,873
103330,1058,1025,134,96,924,941
103432,1047,916,152,104,895,822
101871,998,734,174,101,824,644
98352,955,549,211,121,744,448
97970,1078,594,294,159,784,491
96612,1179,442,356,178,823,355
92166,1348,451,381,169,967,361
85941,1495,426,384,163,1111,378
79256,1603,528,363,158,1240,460
73489,1589,573,349,140,1240,494
69403,1599,573,331,131,1268,496
66740,1657,663,327,112,1330,601
65191,1663,742,337,101,1326,687
64715,1516,651,324,96,1192,588
65799,1524,699,326,95,1198,626
68112,1484,620,342,101,1142,546
70930,1494,549,364,102,1130,478
75025,1548,494,345,113,1203,425
79127,1368,604,307,144,1061,533
81958,1336,896,268,149,1068,827
83381,1421,1084,251,164,1170,997
83634,1487,1194,249,195,1238,1091
83618,1530,1214,266,219,1264,1072
83238,1564,1142,256,218,1308,1023
83028,1519,958,232,201,1287,848
83153,1381,832,208,162,1173,709
83198,1245,786,192,159,1053,654
82827,1122,785,182,138,940,654
84278,1070,658,201,162,869,502
84723,1171,600,244,178,927,437
81724,1237,586,244,161,993,448
77386,1321,587,278,207,1043,407
72079,1404,555,337,229,1067,351
67304,1351,441,375,194,976,303
63835,1263,438,401,212,862,298
61703,1159,440,396,233,763,315
60265,1042,381,368,211,674,272
59766,1032,376,363,220,669,240
60239,1039,476,330,218,709,303
61811,1054,528,326,220,728,375
63160,1203,790,325,247,878,634
67053,1155,783,306,246,849,661
70952,988,866,272,222,716,771
73470,974,1135,262,211,712,1040
75005,990,1167,261,213,729,1106
75955,992,1105,270,224,722,1029
76379,1037,1095,283,243,754,1007
76546,1024,1023,285,252,739,932
76808,879,830,260,240,619,748
77758,729,589,249,232,480,494
78601,624,487,233,227,391,375
78981,563,433,223,205,340,309
81691,601,386,238,197,363,245
82791,804,488,275,187,529,360
78970,990,562,319,190,671,439
73777,1052,555,284,155,768,483
68589,1028,532,271,136,757,461
64632,1019,506,261,123,758,438
62051,1021,466,269,138,752,409
60847,1068,457,286,185,782,378
60594,1047,385,282,188,765,312
61795,1022,413,260,190,762,348
66587,934,384,217,139,717,322
75318,812,346,190,107,622,289
80395,709,279,150,89,559,211
82210,640,235,128,81,512,180
83644,372,133,107,78,265,81
85135,199,113,85,69,114,63
85812,242,180,87,71,155,125
86178,338,369,94,77,244,308
86696,395,470,97,85,298,404
86602,407,443,98,88,309,378
86433,423,429,97,86,326,367
86686,407,377,89,78,318,326
86789,443,358,81,74,362,311
86179,467,285,71,69,396,252
88599,560,238,92,69,468,198
89042,914,378,115,71,799,344
84559,1187,527,136,68,1051,487
78316,1340,651,134,51,1206,620
71761,1323,686,133,52,1190,650
67306,1334,662,150,50,1184,635
64449,1337,628,163,37,1174,607
62970,1280,587,185,81,1095,539
62615,1247,508,215,112,1032,468
63764,1186,480,225,124,961,411
68185,1079,377,217,139,862,289
76989,1076,214,230,131,846,168
81823,1095,233,225,129,870,211
82904,1128,320,195,111,933,310
83861,826,265,173,118,653,232
85006,628,277,184,136,444,216
86100,670,418,163,127,507,386
86703,722,432,139,122,583,398
87605,717,385,137,125,580,339
88182,723,417,135,117,588,390
88393,745,525,125,85,620,534
88951,750,526,119,62,631,546
88890,742,398,120,63,622,417
87858,826,355,122,62,704,373
90121,990,218,162,61,828,223
90418,1481,255,232,76,1249,263
85772,1855,258,272,93,1583,263
79094,1957,336,307,122,1650,342
72645,1932,425,305,130,1627,404
67744,1925,405,292,105,1633,394
64859,1755,442,310,115,1445,416
63327,1616,463,305,131,1311,412
62650,1372,439,273,128,1099,365
63731,1251,463,266,128,985,403
68142,1193,516,265,133,928,431
77043,1153,526,255,134,898,442
81732,1094,522,230,123,864,447
82855,1033,525,192,120,841,447
84272,678,441,137,141,541,336
86036,446,370,111,125,335,264
87106,465,369,100,109,365,277
87679,626,580,80,93,546,501
88497,811,753,74,85,737,684
88931,799,722,79,87,720,656
89143,795,680,78,88,717,621
89513,864,709,81,93,783,652
89406,879,739,82,102,797,680
88517,951,746,108,131,843,700
90649,971,623,122,115,849,593
90920,1282,615,138,103,1144,603
86091,1559,691,152,100,1407,668
79487,1599,762,167,107,1432,734
73382,1512,781,179,108,1333,760
67945,1453,669,197,102,1256,641
65100,1564,711,227,125,1337,669
63745,1578,733,242,135,1336,644
63050,1464,685,252,150,1212,550
63945,1339,652,251,153,1088,508
68299,1143,539,265,170,878,391
77007,1147,611,272,157,875,465
81771,1109,590,283,158,826,447
83239,1148,611,265,154,883,478
85079,1026,646,252,157,774,514
87118,948,756,246,167,702,616
88689,1106,1035,241,165,865,916
89876,1229,1122,224,157,1005,1002
91254,1246,1184,198,144,1048,1066
91961,1226,1308,192,149,1034,1179
92249,1278,1418,205,160,1073,1272
92422,1346,1473,211,153,1135,1349
91904,1355,1482,211,151,1144,1351
90470,1302,1296,225,152,1077,1172
92271,1161,880,254,140,907,774
92091,1361,699,277,140,1084,589
87569,1720,627,272,142,1448,509
80652,1906,561,295,141,1611,469
73997,1907,599,287,148,1620,520
68788,1955,745,288,153,1667,680
65611,1985,833,283,156,1702,765
63983,1915,900,264,166,1651,843
62990,1755,978,237,149,1518,901
64001,1620,1036,224,142,1396,944
68115,1556,1061,204,136,1352,974
76359,1431,1062,197,142,1234,974
81231,1248,975,193,151,1055,886
83063,1102,894,163,136,939,797
85048,769,634,123,118,646,552
87138,635,629,118,137,517,534
88416,830,1036,105,117,725,973
89408,1020,1435,91,104,929,1372
90478,1001,1398,77,89,924,1341
90729,1011,1390,71,82,940,1343
90578,1016,1350,60,73,956,1315
90402,1026,1283,61,70,965,1257
89601,1003,1121,65,76,938,1117
87697,950,857,72,89,878,864
88240,860,375,92,102,768,397
87515,1084,221,114,111,970,280
83655,1180,343,139,118,1041,370
78428,1163,436,136,103,1027,405
72370,1186,556,135,118,1051,475
67313,1126,578,132,124,994,486
64161,994,561,134,128,860,494
62026,919,528,128,106,791,484
60955,841,493,137,95,704,465
60684,807,457,144,99,663,445
62061,803,482,141,83,662,480
64669,822,550,140,70,682,538
67218,921,589,152,94,769,546
71226,967,607,156,107,811,559
74839,862,633,161,140,701,534
77100,844,760,199,211,645,586
78635,975,792,224,239,751,613
79381,1063,832,218,225,845,712
79841,1119,943,213,213,906,850
80144,1146,988,217,207,929,892
80683,1142,983,195,179,947,911
81214,1186,1034,190,169,996,960
81424,1143,1033,193,181,950,936
80728,1051,964,200,189,851,842
83052,960,816,226,198,734,690
82924,1159,865,257,205,902,726
79856,1238,843,252,184,986,720
75460,1227,850,243,174,984,732
70353,1242,948,276,204,966,772
65267,1273,1022,278,217,995,824
62103,1221,1013,288,236,933,793
60610,1193,1065,274,220,919,862
59078,1121,1072,259,204,862,878
58630,1061,1043,269,243,792,805
59216,1057,1083,256,236,801,850
60830,1043,1123,249,241,794,884
62499,1031,1038,240,238,791,800
65836,1024,898,223,222,801,677
69457,956,835,197,215,759,628
71717,1041,1057,187,208,854,865
73566,1111,1170,207,218,904,966
74853,1139,1144,191,220,948,950
75389,1123,1064,190,249,933,854
75768,1131,1069,194,253,937,852
76310,1221,1149,200,250,1021,922
77263,1375,1297,207,253,1168,1070
78080,1449,1366,211,264,1238,1133
78975,1420,1399,228,265,1192,1158
82621,1425,1369,250,269,1175,1138
82559,1457,1246,251,271,1206,1011
78408,1582,1178,242,281,1340,950
73220,1634,1039,241,268,1393,853
68129,1553,893,240,259,1313,730
64609,1374,804,233,242,1141,656
62436,1294,799,219,247,1075,658
61124,1292,785,223,265,1069,619
60854,1252,783,230,271,1022,608
62289,1226,843,251,256,975,639
66928,1302,888,240,270,1062,664
75854,1365,888,247,261,1118,663
81362,1396,831,232,254,1164,609
83304,1386,846,225,257,1161,614
85134,1275,903,215,260,1060,652
87002,1265,1060,223,275,1042,801
88553,1337,1091,223,271,1114,843
89558,1310,1030,221,255,1089,801
90451,1203,999,221,239,982,774
90756,1165,944,226,243,939,718
90695,1233,908,242,238,991,698
90941,1302,922,265,235,1037,723
90793,1460,979,265,246,1195,754
90292,1421,1007,250,255,1171,778
92972,1364,867,245,239,1119,656
92266,1455,698,236,216,1219,509
87337,1582,584,248,202,1334,438
80560,1628,588,258,198,1370,512
73730,1555,596,244,180,1311,548
68614,1525,648,229,151,1296,627
65553,1410,631,220,134,1190,623
63787,1323,608,230,139,1093,590
63114,1211,516,235,135,976,508
64092,1152,492,240,129,912,478
68446,1121,537,233,121,888,518
77300,1096,575,225,112,871,552
82361,1136,610,222,104,914,595
84131,1119,591,191,101,928,592
86321,882,528,152,93,730,514
88967,887,689,121,74,766,665
91163,1028,907,114,69,914,865
92711,1090,1009,111,73,979,951
94448,1160,1095,109,74,1051,1040
95594,1216,1131,117,82,1099,1076
96482,1319,1172,134,87,1185,1122
97149,1425,1203,152,87,1273,1158
96990,1473,1267,163,93,1310,1199
95644,1425,1203,162,93,1263,1117
97640,1362,1025,205,106,1157,932
96733,1442,953,237,132,1205,840
91321,1651,1036,261,136,1390,922
84012,1730,1079,271,145,1459,961
76733,1727,1131,283,167,1444,1003
71265,1698,1064,299,187,1399,935
67856,1733,1068,301,195,1432,942
65722,1687,1057,296,200,1391,937
64856,1558,1035,294,213,1264,924
65604,1448,975,288,204,1160,882
69840,1375,990,278,203,1097,888
78808,1356,900,292,209,1064,808
84048,1470,1071,305,217,1165,983
86040,1508,1136,263,189,1245,1054
88842,1343,1181,218,158,1125,1077
92151,1342,1320,207,152,1135,1226
94863,1468,1443,193,147,1275,1339
97148,1474,1489,221,165,1253,1367
99939,1509,1540,227,176,1282,1408
102046,1519,1594,224,163,1295,1470
103430,1492,1640,230,160,1262,1505
104427,1506,1718,239,170,1267,1568
103979,1442,1762,240,205,1202,1563
101616,1389,1692,242,215,1147,1479
102861,1448,1634,268,214,1180,1421
101133,1559,1465,280,210,1279,1258
95655,1572,1352,291,208,1281,1145
87620,1689,1430,294,212,1395,1221
79913,1842,1482,302,225,1540,1260
73800,1759,1512,310,220,1449,1297
70044,1621,1555,303,216,1318,1346
67698,1547,1556,290,238,1257,1325
66742,1487,1480,278,225,1209,1263
67134,1514,1491,263,222,1251,1275
71326,1656,1577,253,230,1403,1358
80263,1728,1658,260,234,1468,1445
85826,1700,1648,286,264,1414,1404
88172,1704,1575,304,280,1400,1318
90968,1890,1696,291,291,1599,1425
94113,2035,1912,278,291,1757,1633
96730,2094,1949,277,301,1817,1656
98445,2047,1889,270,298,1777,1597
100657,1893,1832,259,292,1634,1543
101996,1852,1787,257,293,1595,1497
102702,1940,1844,256,288,1684,1560
102938,1947,1865,273,299,1674,1571
102396,1940,1823,271,293,1669,1534
101546,1871,1814,291,310,1580,1508
103403,1772,1755,281,300,1491,1457
101855,1812,1639,290,298,1522,1345
96815,1976,1489,306,298,1670,1200
89595,2041,1247,297,272,1744,986
81715,2091,1052,300,266,1791,804
75288,2033,888,290,263,1743,664
71322,2037,877,294,265,1743,651
68911,2070,795,284,251,1786,589
67467,1965,715,294,244,1671,527
67957,1921,794,289,238,1632,623
72097,1783,804,268,206,1515,671
80780,1735,815,259,209,1476,707
86327,1771,794,247,187,1524,721
89030,2012,926,279,227,1733,774
92482,1844,1157,248,222,1596,968
96338,1732,1375,217,190,1515,1204
100000,1760,1370,201,175,1559,1202
103152,1802,1353,187,167,1615,1188
106234,1949,1377,188,172,1761,1206
108023,2047,1330,191,172,1856,1163
108806,2078,1307,196,172,1882,1145
108826,2093,1175,180,147,1913,1040
107190,2011,918,183,134,1828,797
104194,1846,815,203,167,1643,676
104267,1779,569,250,188,1529,438
101394,2028,520,300,192,1728,440
96599,2276,582,348,185,1928,523
90048,2424,591,358,168,2066,537
82831,2385,706,363,155,2022,653
76544,2287,781,350,157,1937,730
72161,2132,797,349,169,1783,757
69189,2022,778,328,182,1694,744
67367,1970,762,313,174,1657,752
66704,1940,770,298,181,1642,746
67671,1707,862,261,161,1446,847
70426,1586,899,251,165,1335,893
73457,1561,912,228,153,1333,904
77885,1491,845,196,139,1295,835
83441,1275,868,146,131,1129,844
88495,1288,994,137,157,1151,944
92394,1257,990,130,137,1127,924
95427,1157,921,125,125,1032,855
97800,1115,977,115,120,1000,946
99356,1102,893,90,88,1012,872
100346,1187,868,78,66,1109,850
100196,1120,713,61,51,1059,694
99463,982,508,40,29,942,494
97801,871,391,48,28,823,367
98607,846,294,79,42,767,255
96162,965,319,107,68,858,313
91962,926,304,133,92,793,304
86521,950,403,161,110,789,321
80399,1112,548,194,118,918,452
74616,1233,560,203,123,1030,464
70275,1287,616,220,139,1067,489
67347,1343,696,223,134,1120,564
65234,1335,725,229,147,1106,579
64316,1264,819,238,176,1026,646
64616,1221,893,250,208,971,691
66164,1203,928,245,209,958,724
68285,1115,935,238,205,877,747
72323,1171,752,226,187,945,580
77330,1030,670,197,168,833,506
81792,992,621,191,160,801,468
85641,1118,671,196,158,922,526
89200,1286,781,214,175,1072,632
91604,1404,873,228,177,1176,726
93246,1497,992,248,180,1249,836
94403,1505,991,279,198,1226,815
95027,1610,1037,311,209,1299,849
95112,1636,1094,311,201,1325,903
94768,1490,1038,314,220,1176,822
96570,1307,775,323,229,984,573
94630,1375,756,342,247,1033,604
89692,1489,850,351,248,1138,775
83048,1580,980,345,235,1235,908
76674,1617,1070,359,232,1258,1004
71910,1492,925,350,223,1142,833
68822,1510,951,343,221,1167,852
67046,1534,993,362,212,1172,877
66597,1562,1031,359,223,1203,932
67655,1444,962,342,224,1102,881
72300,1301,841,317,229,984,702
81476,1202,778,282,230,920,634
87617,1292,878,248,207,1044,775
90014,1472,997,267,230,1205,891
91844,1373,936,275,234,1098,810
93555,1342,943,255,235,1087,804
94481,1500,1038,270,260,1230,903
94100,1608,1122,269,239,1339,1001
93919,1558,1072,251,223,1307,941
92728,1553,987,240,219,1313,841
91280,1656,967,257,195,1399,848
90530,1720,880,294,158,1426,818
89954,1631,907,297,156,1334,855
90109,1376,883,302,158,1074,826
92201,1205,696,309,161,896,611
90535,1396,821,347,174,1049,738
85711,1579,920,344,174,1235,852
79197,1675,870,347,219,1328,782
72486,1602,731,368,268,1234,586
67378,1602,743,368,303,1234,616
64375,1561,832,349,275,1212,753
62757,1586,796,314,239,1272,717
62277,1547,650,281,207,1266,574
63104,1526,645,240,169,1286,548
67534,1421,637,208,167,1213,502
76648,1253,649,191,172,1062,514
81846,1226,676,199,179,1027,549
82826,1291,661,189,181,1102,540
83744,997,547,166,204,831,417
84941,822,504,172,235,650,343
85655,1046,747,187,276,859,544
85962,1324,970,187,288,1137,733
86336,1499,1014,182,276,1317,787
86239,1569,1010,189,281,1380,791
86688,1604,1009,206,290,1398,805
86456,1654,986,205,267,1449,816
85811,1622,885,196,252,1426,748
86587,1400,672,197,230,1203,603
89609,1229,344,208,200,1021,379
88745,1458,229,223,186,1235,340
84417,1742,244,264,195,1478,385
77889,1992,210,311,211,1681,388
71508,2148,256,366,227,1782,352
66841,2243,245,417,233,1826,270
64185,2259,173,422,185,1837,171
62692,2217,159,433,191,1784,148
62136,2057,184,417,191,1640,153
63417,1952,142,412,198,1540,211
67984,1807,355,418,188,1389,411
76653,1895,463,437,199,1458,491
82133,1834,475,438,212,1396,519
83120,1788,481,405,221,1383,552
83931,1533,522,374,224,1159,586
84898,1453,681,364,244,1089,745
85517,1559,855,386,272,1173,919
85572,1615,924,392,304,1223,975
85923,1612,870,401,336,1211,932
85726,1632,835,407,336,1225,901
85457,1647,877,386,310,1261,934
85757,1621,885,360,306,1261,954
86179,1551,862,374,283,1177,909
87517,1421,695,401,251,1020,694
90080,1435,676,428,247,1007,620
88733,1644,739,439,245,1205,662
84641,1785,714,440,235,1345,658
78272,1776,702,414,218,1362,621
72134,1522,685,373,165,1149,588
67384,1423,678,361,147,1062,578
64621,1284,642,336,148,948,531
63148,1226,646,286,157,940,517
62704,1113,614,254,161,859,491
63687,992,630,241,158,751,524
68527,1003,697,229,144,774,624
77118,1025,758,256,171,769,700
83071,1009,815,223,153,786,753
84331,1041,817,201,140,840,747
85342,934,836,194,128,740,786
86562,838,942,187,127,651,881
87244,845,1034,177,142,668,935
87508,956,1277,158,166,798,1143
87787,988,1326,142,160,846,1202
87651,969,1294,135,147,834,1183
87361,946,1285,154,177,792,1132
87638,926,1211,156,174,770,1059
87885,896,1049,160,171,736,904
89020,741,743,167,171,574,601
91070,645,439,191,181,454,309
89646,772,303,202,188,570,208
85450,965,200,202,171,763,170
79175,1237,335,228,196,1009,366
72951,1411,430,240,210,1171,465
68091,1460,381,255,202,1205,398
65177,1626,437,253,219,1373,447
63612,1760,522,257,197,1503,512
63172,1738,712,269,185,1469,624
64051,1718,906,252,149,1466,798
68239,1771,962,260,156,1511,824
76661,1782,1066,263,162,1519,922
82628,1760,1109,249,151,1511,975
84154,1687,955,221,123,1466,863
85679,1440,891,170,100,1270,817
87087,1107,860,139,90,968,785
87818,1184,968,100,69,1084,916
88044,1234,828,86,51,1148,798
88415,1351,783,80,38,1271,772
87864,1456,797,80,23,1376,800
87297,1478,781,84,25,1394,789
87139,1498,720,93,23,1405,732
86743,1545,740,117,31,1428,750
86809,1382,679,172,76,1210,668
87859,1484,721,245,113,1239,669
86155,2048,833,255,73,1793,772
82840,2585,831,340,94,2245,754
77837,2813,833,386,121,2427,739
72150,2818,840,394,143,2424,736
67358,2796,825,404,163,2392,751
64068,2801,836,413,159,2388,789
62211,2795,771,414,155,2381,731
61032,2680,714,418,144,2262,683
60982,2566,744,386,118,2180,737
62163,2414,700,346,98,2068,685
64975,2352,554,330,108,2022,534
68140,2371,643,299,123,2072,641
71274,2401,678,240,87,2161,701
74722,2033,745,183,109,1850,790
76970,1782,853,171,146,1611,918
77795,1761,813,167,149,1594,887
77897,1730,729,180,154,1550,818
77584,1634,670,203,178,1431,771
77296,1725,793,222,174,1503,886
77101,1946,983,229,146,1717,1062
77570,1938,1008,238,104,1700,1061
78007,1938,1064,241,59,1697,1090
79245,1920,1110,283,49,1637,1077
82023,2002,1103,375,106,1627,1009
80791,2108,895,416,133,1692,800
77999,2272,661,435,150,1837,604
73855,2285,638,420,159,1865,611
69169,2348,785,411,164,1937,750
64793,2316,736,406,151,1910,728
61843,2347,862,420,164,1927,853
59897,2149,888,420,166,1729,864
58719,2017,1067,375,170,1642,1022
58346,1838,936,359,161,1479,872
59033,1757,821,364,119,1393,808
60934,1660,754,366,95,1294,777
63393,1608,802,385,97,1223,842
66233,1646,747,383,80,1263,785
69659,1644,863,334,74,1310,883
71834,1553,995,298,60,1255,969
73160,1475,897,260,55,1215,854
73919,1537,885,232,72,1305,859
74068,1639,945,221,96,1418,936
74058,1658,927,252,142,1406,937
74262,1882,1054,261,128,1621,1065
75033,1900,1120,271,112,1629,1104
76273,1949,1245,319,112,1630,1191
78713,1997,1209,373,133,1624,1136
82013,1992,1131,424,139,1568,1060
81292,2152,1218,474,132,1678,1125
77628,2326,1306,491,134,1835,1186
73233,2242,1261,490,144,1752,1120
68478,2162,1269,476,136,1686,1134
64607,2129,1288,476,125,1653,1165
62238,2014,1233,458,135,1556,1102
60875,1927,1216,427,142,1500,1083
60796,1884,1131,413,149,1471,993
61888,1872,1041,416,172,1456,893
65972,1864,1004,403,219,1461,830
73716,1887,996,411,235,1476,819
79471,1891,1026,406,253,1485,852
81518,1917,993,381,271,1536,836
83607,1738,1024,351,279,1387,893
85119,1501,1055,337,282,1164,937
86066,1571,912,298,281,1273,790
86327,1636,923,271,270,1365,800
86449,1614,982,278,282,1336,823
86375,1593,850,285,295,1308,684
86016,1649,918,299,301,1350,725
85999,1667,956,289,290,1378,756
86070,1694,950,299,285,1395,752
87391,1635,1060,322,312,1313,844
90653,1654,1095,344,332,1310,875
88737,2071,1038,342,337,1729,899
84372,2283,955,336,341,1947,899
78422,2383,1015,374,318,2009,943
72312,2368,925,394,316,1974,866
67557,2166,771,390,308,1776,709
64547,2079,693,410,295,1669,584
63100,1946,566,385,261,1561,479
62507,1777,516,352,188,1425,415
63624,1830,526,343,168,1487,456
68244,1803,532,337,172,1466,504
77171,1866,633,325,152,1541,587
82940,1880,664,316,154,1564,635
84138,1946,550,277,139,1669,601
84971,1769,469,224,112,1545,539
86274,1643,415,224,100,1419,474
86952,1796,626,208,91,1588,662
87260,2042,875,207,85,1835,906
87599,2153,978,200,82,1953,1013
87400,2250,970,202,94,2048,1022
87079,2268,999,197,70,2071,1010
87063,2322,1115,203,97,2119,1100
87316,2303,1193,222,128,2081,1153
89251,2121,1026,289,166,1832,965
91770,2171,1066,370,151,1801,986
89846,2339,1291,402,163,1937,1165
85560,2447,1437,439,169,2008,1304
78874,2422,1442,436,151,1986,1335
72476,2370,1461,445,150,1925,1358
67898,2240,1496,408,140,1832,1396
64998,2194,1448,376,131,1818,1376
63561,2166,1391,380,138,1786,1300
63055,2169,1389,374,143,1795,1302
64156,2029,1465,336,139,1693,1376
68671,1989,1508,347,164,1642,1384
77542,2072,1452,358,172,1714,1312
83289,2045,1353,358,177,1687,1199
84709,2027,1242,360,161,1667,1098
85759,1728,1010,319,158,1409,888
86979,1676,861,282,139,1394,771
87366,1707,794,263,130,1444,706
87468,1844,914,239,132,1605,796
87968,1849,942,234,124,1615,831
87745,1824,933,218,112,1606,836
87196,1945,1020,222,113,1723,926
87209,1962,1066,199,101,1763,989
87306,1888,1081,205,121,1683,986
89111,1781,893,217,113,1564,850
91781,1804,725,277,143,1527,717
90087,2021,673,302,147,1719,698
85981,2158,755,304,156,1854,793
79804,2374,905,280,138,2094,956
73313,2439,945,291,121,2148,1011
68396,2320,885,276,108,2044,939
65560,2180,1034,267,112,1913,1014
64004,2228,1161,250,114,1978,1115
63402,2141,1260,268,140,1873,1147
64528,2142,1350,259,163,1883,1206
69053,2172,1380,238,153,1934,1242
77894,2129,1387,238,171,1891,1231
84026,2187,1419,232,166,1955,1270
85363,2112,1285,216,165,1896,1134
86370,1951,1214,199,151,1752,1094
87991,2096,1228,222,177,1874,1123
88900,2231,1185,227,197,2004,1083
89219,2350,1171,224,200,2126,1120
89471,2509,1099,226,200,2283,1069
88925,2649,1033,214,160,2435,1020
88510,2782,921,243,154,2539,923
88582,2691,929,266,142,2425,948
88830,2610,971,286,135,2324,1000
90635,2505,1047,352,142,2153,1114
92953,2453,1053,398,133,2055,1122
91270,2647,1116,473,180,2174,1188
87478,2671,1186,493,139,2178,1220
81153,2789,1278,475,86,2314,1246
74822,2895,1230,466,109,2429,1167
69808,2950,1126,466,113,2484,1064
66760,2874,1152,459,138,2415,1091
64977,2797,1196,457,187,2340,1133
64128,2847,1164,475,161,2372,1108
65032,2971,1160,509,156,2462,1103
69177,2939,1121,522,155,2417,1059
77424,2905,1054,548,163,2357,989
83104,2735,1068,536,178,2199,969
84422,2510,1034,511,154,1999,955
85158,2238,915,490,118,1748,862
85855,2297,985,510,105,1787,928
85974,2381,898,536,72,1845,847
85704,2510,902,555,88,1955,830
85528,2532,879,544,96,1988,803
84873,2413,839,540,117,1873,761
83943,2319,904,525,166,1794,778
83396,2155,929,515,179,1640,801
82725,1897,818,461,181,1436,687
83732,1597,720,396,188,1201,579
85787,1530,711,388,175,1142,599
84143,1624,590,402,190,1222,524
81401,1779,634,415,214,1364,589
76921,1747,616,416,222,1331,587
71681,1658,541,393,226,1265,576
67213,1521,530,374,239,1147,576
64438,1398,604,349,274,1049,626
62670,1368,705,327,283,1041,726
61959,1445,849,318,284,1127,893
62211,1407,879,276,250,1131,934
63769,1366,885,263,268,1103,921
66973,1391,918,262,274,1129,947
70725,1378,857,260,276,1118,852
74141,1449,889,254,289,1195,877
76716,1456,955,241,295,1215,953
78058,1413,1057,221,283,1192,1087
78218,1549,1189,228,267,1321,1229
77573,1668,1217,240,248,1428,1240
76756,1802,1261,247,243,1555,1275
75925,1986,1270,251,246,1735,1277
75620,2130,1286,277,243,1853,1261
76061,2211,1259,289,225,1922,1202
77089,2116,1269,263,185,1853,1168
79582,2023,1229,243,150,1780,1132
81853,2063,1230,295,170,1768,1110
80751,2318,1275,361,232,1957,1098
78318,2644,1237,401,245,2243,1057
74732,2763,1250,443,247,2320,1067
70359,2714,1250,449,234,2265,1068
66608,2768,1160,489,218,2279,1002
63947,2680,1304,499,199,2181,1139
62447,2584,1329,485,168,2099,1211
61593,2702,1324,486,146,2216,1219
61675,2604,1190,502,155,2102,1099
62841,2389,1175,466,168,1923,1040
65363,2329,1219,411,198,1918,1033
68332,2204,1109,405,205,1799,918
71207,2155,1045,392,186,1763,878
73238,1964,959,385,174,1579,808
73315,1789,997,356,143,1433,879
73283,1813,1005,320,84,1493,932
72925,1814,890,290,66,1524,835
72506,1959,712,281,54,1678,666
71901,2151,660,293,58,1858,633
71758,2226,735,287,89,1939,733
72619,2243,779,285,111,1958,764
74219,2302,874,295,127,2007,844
78095,2134,914,325,153,1809,873
82545,2134,884,381,159,1753,826
82020,2273,921,370,95,1903,879
78709,2288,899,366,66,1922,900
74474,2354,852,406,95,1948,867
70043,2325,835,402,104,1923,835
66802,2234,833,384,119,1850,819
64994,2160,898,359,116,1801,867
64184,2118,814,350,100,1768,783
64393,2180,922,312,82,1868,881
66276,2056,917,278,80,1778,872
71893,1862,697,272,90,1590,647
81880,1740,516,271,86,1469,457
88254,1862,538,277,71,1585,487
88967,1953,591,257,102,1696,516
88212,1897,677,216,176,1681,591
87792,1652,493,188,155,1464,485
87154,1609,442,184,121,1425,508
86401,1662,575,188,136,1474,639
85958,1707,598,179,131,1528,655
84966,1764,519,185,113,1579,557
84406,1829,453,213,139,1616,476
84349,1933,552,242,177,1691,531
85054,2006,625,261,190,1745,576
88261,1907,599,293,207,1614,518
91599,1991,547,370,220,1621,451
89970,2186,532,417,255,1769,469
85598,2237,564,449,256,1788,559
79490,1988,595,467,251,1521,530
73669,1865,572,470,258,1395,498
69159,1796,603,482,265,1314,492
66680,1741,692,483,268,1258,530
65600,1624,604,506,262,1118,379
65280,1603,606,530,268,1073,367
66789,1555,596,508,261,1047,377
71859,1537,534,531,238,1006,350
81423,1510,470,541,226,969,310
87472,1531,452,567,215,964,305
87781,1568,479,573,201,995,360
87456,1430,494,518,235,912,339
87762,1307,490,482,270,825,341
87639,1324,522,472,283,852,377
87399,1348,614,476,290,872,477
87127,1379,744,472,286,907,618
86209,1402,797,476,297,926,642
85193,1456,839,489,313,967,676
84972,1426,881,482,331,944,649
86056,1437,810,478,347,959,559
89351,1451,712,480,355,971,444
92640,1640,773,496,351,1144,470
91107,2036,1004,516,349,1520,720
87321,2221,1044,514,349,1707,785
81250,2348,1160,514,325,1834,927
75191,2445,1202,513,335,1932,989
70987,2445,1240,496,341,1949,1020
68595,2332,1304,485,356,1847,1073
67460,2353,1224,498,358,1855,969
67309,2347,1204,493,351,1854,939
68807,2329,1133,485,353,1844,856
73811,2284,1023,481,368,1803,748
83168,2191,926,491,376,1700,623
89594,2262,990,482,374,1780,700
90249,2224,1133,463,378,1761,845
90304,2071,1088,430,382,1641,789
90329,1810,886,402,386,1408,629
89748,1798,943,359,362,1439,697
89184,1966,1121,354,339,1612,889
88860,2143,1388,391,366,1752,1157
87980,2414,1548,418,373,1996,1329
87676,2496,1442,411,345,2085,1302
88319,2561,1384,405,322,2156,1283
89863,2436,1298,371,311,2065,1256
93641,2390,1187,375,296,2015,1194
95851,2496,1198,422,286,2074,1200
94511,2577,1347,461,259,2116,1297
90913,2623,1362,480,228,2143,1267
85124,2644,1362,486,226,2158,1250
79290,2558,1178,474,224,2084,1092
74873,2438,1063,486,202,1952,1026
72581,2438,1024,531,198,1907,976
71505,2448,987,545,176,1903,944
71353,2486,908,537,193,1949,882
72957,2434,808,530,208,1904,813
78257,2364,804,537,216,1827,794
87978,2324,818,548,233,1776,798
94075,2360,882,569,221,1791,872
93858,2329,950,554,224,1775,938
92878,2108,982,503,206,1605,971
92318,2019,1028,484,222,1535,1011
91212,2064,1100,502,263,1562,1044
90515,2034,1089,513,252,1521,1072
90164,2021,1087,517,256,1504,1063
89526,2085,1129,505,279,1580,1084
88671,2180,958,521,276,1659,940
89216,2362,1000,516,282,1846,981
90735,2420,1065,502,292,1918,1042
94968,2280,1028,492,277,1788,988
97931,2408,985,508,269,1900,925
96623,2548,806,521,264,2027,768
93416,2595,626,565,275,2030,618
87544,2573,476,587,278,1986,502
81808,2523,343,589,275,1934,387
77545,2438,362,578,274,1860,247
75388,2093,495,537,259,1556,249
74387,1992,434,523,244,1469,196
74486,2028,442,508,233,1520,215
76423,1928,406,467,209,1461,207
81550,1854,384,462,201,1392,186
91091,1744,345,431,173,1313,191
97085,1648,402,414,160,1234,265
96754,1571,392,388,156,1183,277
95300,1312,352,373,162,939,253
93758,1192,344,390,180,802,248
91808,1354,314,445,191,909,244
90082,1459,271,438,195,1021,194
88890,1595,359,446,191,1149,309
87391,1732,459,463,181,1269,448
86315,1873,565,476,184,1397,554
86056,1927,577,498,179,1429,579
86730,1956,686,487,134,1469,676
89876,1831,597,472,111,1359,597
92465,2076,755,494,145,1582,727
91587,2515,976,515,159,2000,925
89748,2690,1019,514,192,2176,940
85949,2867,1039,489,211,2378,945
81046,2683,975,451,209,2232,844
77108,2658,906,416,202,2242,787
74710,2619,945,409,222,2210,790
73861,2656,878,432,278,2224,702
73868,2602,859,381,230,2221,726
74500,2601,848,341,203,2260,734
76836,2561,916,355,236,2206,807
80837,2574,941,377,260,2197,868
84857,2552,860,376,275,2176,849
87403,2518,1015,369,291,2149,1046
87432,2246,1059,343,317,1903,1090
86130,2111,1164,345,338,1766,1161
84174,2158,1188,350,347,1808,1169
82151,2130,1140,338,372,1792,1111
80108,2048,1150,333,373,1715,1084
78758,1980,1139,324,370,1656,1065
77951,1836,1090,335,365,1501,966
78244,1803,1066,338,347,1465,946
79536,1869,882,304,290,1565,873
83203,1771,654,299,251,1472,693
85303,1913,544,326,220,1587,596
84174,2223,608,399,237,1824,665
81950,2490,633,425,240,2065,650
78253,2668,797,430,223,2238,802
73754,2640,837,430,175,2210,841
70060,2706,921,447,180,2259,920
67566,2807,988,470,170,2337,1000
66403,2654,987,469,205,2185,974
66078,2514,1018,441,185,2073,977
66444,2422,1051,443,167,1979,1019
68108,2342,1075,416,135,1926,1022
70881,2217,1094,386,114,1831,1034
74359,2170,1108,383,111,1787,1046
76864,2149,1074,365,140,1784,1025
77950,1953,968,319,153,1634,951
77514,1815,904,304,179,1511,904
76491,1848,759,316,197,1532,801
75607,2049,734,287,199,1762,810
74857,2163,886,266,215,1897,933
73755,2109,921,255,204,1854,966
73309,2218,1051,268,215,1950,1084
73990,2260,1068,278,245,1982,1081
75842,2297,1161,276,263,2021,1161
80768,2179,1349,289,265,1890,1270
84906,2236,1397,327,244,1909,1258
84785,2420,1420,365,259,2055,1253
81843,2603,1509,409,282,2194,1314
77924,2656,1554,427,298,2229,1344
73683,2614,1538,449,287,2165,1338
70655,2571,1542,468,300,2103,1342
69083,2456,1416,491,308,1965,1213
68803,2425,1376,529,310,1896,1157
69332,2387,1346,523,301,1864,1139
71722,2351,1325,530,290,1821,1117
77510,2329,1255,538,287,1791,1055
87686,2319,1095,540,282,1779,891
94257,2487,1178,556,291,1931,961
94410,2530,1200,552,295,1978,955
92897,2538,1287,501,313,2037,1003
91522,2403,1342,473,331,1930,1029
89990,2532,1480,462,329,2070,1154
88446,2671,1592,475,333,2196,1264
87410,2697,1647,453,318,2244,1334
86176,2626,1585,412,277,2214,1311
85234,2565,1535,388,247,2177,1293
85149,2485,1485,348,228,2137,1262
86236,2426,1345,303,171,2123,1176
90787,2540,1371,306,161,2234,1227
93424,2708,1459,325,181,2383,1333
91643,2808,1468,296,157,2512,1393
87816,2814,1496,268,146,2546,1434
81901,2803,1465,301,190,2502,1412
75982,2734,1423,293,188,2441,1365
71838,2811,1388,307,201,2504,1307
69433,2751,1457,285,165,2466,1379
68653,2883,1574,297,150,2586,1464
68587,2998,1642,324,162,2674,1512
70349,2965,1704,322,179,2643,1543
75733,3037,1654,354,204,2683,1480
85413,3156,1675,389,236,2767,1482
91755,3220,1616,468,283,2752,1366
91558,3230,1632,476,298,2754,1353
90345,3146,1621,490,296,2656,1350
89470,3000,1645,481,273,2519,1410
88230,2987,1618,475,268,2512,1382
87205,2987,1610,494,287,2493,1352
86555,2892,1626,509,294,2383,1353
85506,2785,1605,504,293,2281,1331
84890,2672,1480,503,290,2169,1210
84950,2502,1374,471,274,2031,1108
86233,2172,1242,422,265,1750,989
90730,1837,1105,388,262,1449,869
92977,1773,1016,396,281,1377,762
91333,1782,994,390,287,1392,741
87249,1821,974,394,281,1427,742
81342,1821,904,381,216,1440,744
75386,1773,927,369,184,1404,790
71182,1806,982,421,188,1385,830
68461,1738,983,461,191,1277,825
67303,1610,900,457,178,1153,771
66725,1497,753,430,168,1067,638
68359,1423,771,383,163,1040,654
73352,1462,876,345,148,1117,764
82586,1405,869,298,140,1107,802
88883,1419,860,281,157,1138,829
89362,1320,692,264,145,1056,682
89143,1299,797,252,156,1047,781
89251,1191,755,267,184,924,728
88892,1137,772,247,159,890,734
88202,1095,752,220,136,875,685
87532,1095,785,232,150,863,685
86819,1113,884,252,186,861,748
86287,1069,811,212,156,857,692
86407,1103,742,217,171,886,615
87438,1066,798,208,166,858,661
91435,1068,693,213,174,855,556
92290,1178,647,222,171,956,529
90512,1414,755,251,214,1163,632
86754,1592,827,260,234,1332,716
80535,1628,857,243,229,1385,747
74407,1635,901,219,206,1416,811
69597,1598,927,181,172,1417,875
66900,1655,900,173,147,1482,854
65489,1716,793,173,147,1543,725
65041,1746,780,182,170,1564,699
66219,1719,689,208,187,1511,553
70747,1849,855,217,191,1632,694
79830,1922,729,224,195,1698,603
86052,2025,574,228,191,1797,526
87170,2256,464,244,197,2012,485
87677,2423,552,234,188,2189,628
88509,2425,686,226,156,2199,772
88582,2401,804,213,160,2188,871
88191,2260,817,196,156,2064,874
88137,2190,800,175,152,2015,847
87740,2194,737,198,173,1996,775
87438,2413,733,207,177,2206,734
87665,2527,724,202,194,2325,705
88112,2714,743,221,209,2493,753
89496,2763,708,269,230,2494,733
89138,2960,690,315,239,2645,708
88107,3062,684,344,271,2718,724
85102,3169,689,378,291,2791,734
79279,3204,674,416,283,2788,684
73008,3271,710,423,279,2848,655
68526,3231,815,436,282,2795,706
65513,3652,1272,502,266,3150,1132
64185,2997,743,487,249,2510,614
63413,2910,725,517,248,2393,592
64522,2971,761,511,225,2460,653
69292,2968,855,530,220,2438,752
77522,3124,974,571,229,2553,857
84542,3171,973,591,214,2580,891
86249,3029,942,598,213,2431,915
86905,2760,836,584,174,2176,873
87577,2442,749,553,187,1889,824
87540,2306,669,538,177,1768,748
86934,2236,657,508,187,1728,751
86449,2105,634,493,179,1612,706
85527,2088,563,516,156,1572,643
84797,1996,486,512,104,1484,561
84533,1834,479,475,103,1359,502
84672,1769,441,480,159,1289,399
87190,1698,282,501,201,1197,198
87057,1871,528,529,210,1342,483
84903,2037,768,541,183,1496,722
82322,2149,798,526,191,1623,787
77537,2101,750,458,226,1643,773
72289,2084,692,440,237,1644,694
67692,2052,668,439,195,1613,667
64743,2491,932,631,493,1860,629
63026,2138,665,463,209,1675,643
62071,2206,644,466,234,1740,600
62310,2221,621,444,259,1777,554
63760,2111,614,413,292,1698,506
67058,2070,707,400,316,1670,549
71213,2005,722,399,328,1606,530
74270,1937,672,393,334,1544,487
76960,1676,607,367,332,1309,424
78369,1445,675,359,338,1086,446
78372,1500,730,353,342,1147,497
77678,1626,711,371,336,1255,521
76543,1747,795,404,337,1343,603
75692,1800,868,428,337,1372,662
75317,1783,942,430,340,1353,724
75621,1709,938,430,336,1279,731
76823,1657,793,418,310,1239,621
80518,1847,903,404,292,1443,761
81997,2038,986,445,295,1593,851
80736,2139,1103,456,287,1683,964
78501,2094,1131,479,273,1615,1010
75089,2222,1141,476,268,1746,1046
70847,2192,1148,479,248,1713,1060
67029,2132,1180,490,250,1642,1071
64885,2270,1161,599,326,1671,1044
62740,2020,1271,503,245,1517,1097
62766,2031,1258,513,241,1518,1061
63599,2005,1336,535,242,1470,1124
65539,1974,1409,575,242,1399,1207
68499,1921,1499,569,264,1352,1281
71549,1870,1515,566,271,1304,1301
74923,1739,1531,537,266,1202,1330
76432,1567,1449,488,249,1079,1282
76277,1500,1457,449,250,1051,1303
75208,1432,1380,416,221,1016,1258
74668,1408,1311,400,202,1008,1204
73425,1418,1228,408,206,1010,1125
73914,1410,1106,399,208,1011,1045
75023,1413,1054,387,209,1026,1037
77828,1383,965,358,189,1025,942
82940,1405,1006,326,157,1079,976
86789,1647,1212,350,164,1297,1135
86649,2040,1458,367,193,1673,1332
86013,2249,1501,397,212,1852,1370
82707,2279,1464,366,209,1913,1335
78719,2366,1439,345,200,2021,1318
74897,2315,1427,345,193,1970,1299
72667,2268,1470,349,203,1919,1307
71760,2300,1366,397,196,1903,1255
71626,2209,1496,369,225,1840,1331
72408,2256,1508,378,240,1878,1343
74929,2198,1465,396,225,1802,1302
81549,2127,1331,377,172,1750,1228
91474,2048,1248,405,166,1643,1148
95485,2037,1381,388,162,1649,1285
95324,1939,1390,318,130,1621,1348
94236,1702,1356,266,111,1436,1330
93232,1568,1368,234,113,1334,1367
91850,1513,1223,231,109,1282,1228
90566,1556,1130,225,91,1331,1148
89930,1616,1089,224,99,1392,1111
89098,1632,1008,242,93,1390,1032
89031,1552,896,243,81,1309,924
91475,1540,915,279,49,1261,888
97767,1517,898,335,90,1182,828
99927,1625,893,400,108,1225,810
98772,1812,968,439,120,1373,883
96551,1940,1012,496,129,1444,917
91959,2044,1042,519,167,1525,911
86073,2092,1075,507,181,1585,922
80530,2092,1055,494,183,1598,906
76382,2084,1027,486,185,1598,877
73960,2005,938,489,152,1516,815
72985,1947,879,488,131,1459,769
72785,1820,704,446,102,1374,633
74896,1672,596,435,114,1237,519
80116,1592,528,429,113,1163,446
88468,1501,479,423,107,1078,400
92198,1444,466,360,110,1084,398
92178,1411,494,333,116,1078,422
91078,1168,540,276,111,892,478
90565,967,405,214,99,753,382
89641,1043,420,212,109,831,471
88748,1295,789,214,113,1081,868
88158,1400,972,199,114,1201,1038
87440,1524,1043,215,120,1309,1120
87087,1482,954,208,126,1274,1035
88696,1521,983,195,114,1326,1056
94110,1776,1052,207,88,1569,1103
96074,2140,1114,257,117,1883,1123
94884,2376,1084,300,156,2076,1035
92437,2518,1148,348,197,2170,1066
87908,2728,1291,376,246,2352,1196
81972,2785,1297,362,261,2423,1201
76262,2709,1266,341,277,2368,1171
72290,2718,1317,339,283,2379,1218
70066,3103,1470,480,538,2623,1173
68970,2672,1400,345,265,2327,1301
68813,2651,1427,349,239,2302,1330
70429,2655,1402,346,199,2309,1318
75601,2597,1390,344,180,2253,1324
84257,2584,1384,360,162,2224,1318
88003,2545,1378,354,145,2191,1316
88369,2494,1479,341,143,2153,1430
87787,2449,1556,342,144,2107,1505
87876,2454,1646,347,157,2107,1588
87322,2506,1720,369,168,2137,1633
86849,2580,1792,391,213,2189,1674
86478,2500,1721,359,220,2141,1637
86005,2409,1600,350,215,2059,1539
85667,2369,1571,372,189,1997,1483
87114,2286,1516,366,184,1920,1408
92310,2176,1431,405,170,1771,1305
93759,2102,1282,416,151,1686,1182
92123,2036,1282,421,175,1615,1167
89418,2079,1331,428,197,1651,1180
85042,1976,1232,429,201,1547,1068
79311,1915,1057,414,193,1501,889
73665,1841,952,409,195,1432,793
69631,1726,880,354,185,1372,730
67222,1626,802,309,159,1317,676
66009,1579,684,302,174,1277,569
65836,1511,593,299,174,1212,487
67449,1508,581,343,200,1165,448
72612,1400,482,343,199,1057,375
81390,1319,472,350,225,969,354
86146,1186,341,297,220,889,219
87861,1085,370,282,256,803,210
88846,992,534,342,318,650,246
89561,909,640,350,333,559,330
89409,1099,818,379,356,720,537
89114,1420,1124,396,362,1024,900
88950,1684,1376,418,358,1266,1162
88270,1808,1510,403,328,1405,1316
87713,1847,1559,410,317,1437,1361
89131,1748,1378,407,306,1341,1179
94813,1561,1095,413,265,1148,895
97125,1633,1082,425,252,1208,849
96170,1774,1030,437,256,1337,789
94227,1854,953,423,242,1431,761
90401,1935,962,391,229,1544,806
84981,2032,1025,378,220,1654,895
79709,1997,998,374,216,1623,881
75799,1919,950,364,210,1555,866
73939,1932,951,343,210,1589,907
73196,1858,971,338,207,1520,930
73499,1815,843,372,210,1443,836
75538,1757,787,385,240,1372,792
81395,1633,738,381,241,1252,791
90382,1627,725,392,246,1235,840
94371,1617,824,371,226,1246,935
94059,1513,845,319,235,1194,931
92972,1445,849,306,261,1139,933
92188,1512,983,321,285,1191,1042
91482,1637,1051,346,303,1291,1089
90510,1704,1015,366,313,1338,1038
89493,1718,962,385,307,1333,953
88137,1681,883,396,303,1285,819
87706,1753,927,381,297,1372,839
89220,1771,928,351,257,1420,834
95217,1814,940,330,218,1484,849
97166,2121,1123,335,213,1786,1054
95732,2283,1090,367,221,1916,976
94129,2345,1068,375,212,1970,926
91581,2386,1040,369,191,2017,918
87568,2390,1033,365,196,2025,943
82894,2326,976,332,180,1994,923
79028,2282,977,296,166,1986,943
76791,2286,998,305,155,1981,989
75780,2173,968,301,177,1872,977
75643,2136,1026,296,185,1840,1044
76585,2080,986,298,187,1782,1004
79102,2111,993,298,142,1813,1008
82499,2144,961,310,146,1834,977
85261,2151,899,317,157,1834,936
86615,2005,850,284,135,1721,885
86237,1776,799,255,135,1521,890
84866,1790,802,263,128,1527,916
82671,1960,908,285,115,1675,1016
80498,1974,1010,295,97,1679,1081
78649,1951,1127,281,150,1670,1167
77246,1987,1184,295,208,1692,1200
77220,1966,1182,309,229,1657,1165
79393,1864,1154,339,250,1525,1077
85266,1889,1063,397,272,1492,938
87336,2059,1028,442,263,1617,914
86372,2207,1028,476,233,1731,928
84876,2257,1022,504,196,1753,932
83052,2288,1129,517,200,1771,1010
79628,2319,1209,533,202,1786,1081
75037,2307,1156,521,197,1786,1026
71449,2273,1155,494,206,1779,1007
69409,2443,1122,512,221,1931,972
68258,2584,1083,505,213,2079,943
67947,2756,1126,508,207,2248,1005
68492,2815,1242,507,224,2308,1077
70179,2807,1319,466,241,2341,1156
72739,2823,1364,433,239,2390,1232
74879,2760,1347,418,262,2342,1204
76713,2641,1254,365,259,2276,1181
77627,2425,1130,314,268,2111,1087
77364,2507,1191,314,287,2193,1117
77197,2665,1407,333,294,2332,1331
77036,2756,1445,359,301,2397,1421
76727,2622,1398,379,307,2243,1377
76251,2798,1366,396,311,2402,1401
76292,2864,1384,424,286,2440,1439
78558,2915,1387,485,272,2430,1408
85388,3055,1439,603,268,2452,1416
88391,3271,1527,672,256,2599,1467
87934,3454,1598,683,278,2771,1518
86502,3557,1600,684,280,2873,1504
83584,3693,1536,700,261,2993,1452
79682,3861,1368,722,249,3139,1270
75972,3936,1147,719,236,3217,1055
73321,3894,995,697,224,3197,899
71974,3837,922,662,201,3175,807
71776,3700,988,605,208,3095,839
72280,3646,829,570,218,3076,676
74588,3525,650,532,215,2993,496
80178,3415,478,530,193,2885,368
89018,3418,351,528,190,2890,296
93584,3339,247,505,195,2834,265
94048,3238,241,460,180,2778,289
93502,2937,338,409,207,2528,436
92766,2872,441,394,213,2478,504
91478,2874,711,376,229,2498,674
90362,3005,697,358,254,2647,589
90083,3178,665,380,259,2798,539
89348,3326,557,403,253,2923,444
89376,3481,532,444,252,3037,403
91949,3573,458,470,236,3103,295
97847,3465,368,498,230,2967,320
99167,3562,431,543,244,3019,497
97988,3621,450,505,246,3116,479
95673,3542,244,472,246,3070,303
91549,3465,261,475,247,2990,204
85813,3432,57,433,223,2999,230
80377,3349,382,439,185,2910,525
76303,3164,618,430,159,2734,732
74338,3067,770,449,131,2618,847
73456,3069,988,489,95,2580,996
73761,2963,1106,521,51,2442,1083
75888,2963,1242,537,83,2426,1168
81822,2856,1281,552,123,2304,1179
91423,2666,1236,532,129,2134,1128
96544,2620,1374,517,171,2103,1230
97470,2589,1485,524,218,2065,1312
97862,2510,1552,521,238,1989,1385
98370,2423,1639,482,253,1941,1478
98368,2406,1570,460,242,1946,1426
98290,2518,1590,475,231,2043,1441
98450,2717,1720,525,244,2192,1541
98195,2791,1767,548,246,2243,1574
98747,2817,1749,544,241,2273,1540
101503,2720,1761,539,234,2181,1538
107405,2558,1636,539,197,2019,1440
109523,2573,1551,573,150,2000,1403
108623,2686,1416,663,134,2023,1298
106467,2757,1400,710,132,2047,1295
102572,2770,1355,707,150,2063,1250
96553,2763,1282,680,144,2083,1174
90898,2799,1259,649,167,2150,1134
87164,2914,1271,670,195,2244,1126
85413,2888,1321,646,230,2242,1132
84892,2826,1400,623,257,2203,1190
85424,2795,1479,637,282,2158,1258
87589,2743,1394,621,278,2122,1173
93574,2669,1442,568,276,2101,1227
102985,2665,1556,534,266,2131,1333
106482,2737,1566,524,282,2213,1326
104834,2729,1654,525,296,2204,1398
102758,2435,1525,491,296,1944,1283
101232,2243,1507,431,302,1812,1256
99534,2316,1573,404,296,1912,1320
97747,2485,1647,390,290,2095,1402
96285,2530,1649,367,281,2163,1412
95045,2603,1646,343,267,2260,1415
95030,2746,1654,344,253,2402,1435
97875,2756,1642,352,244,2404,1427
105629,2675,1568,406,247,2269,1339
108688,2853,1599,476,271,2377,1347
108277,2926,1627,523,301,2403,1345
106648,3010,1609,558,291,2452,1333
102861,3128,1607,570,295,2558,1328
97064,3259,1612,578,289,2681,1345
91391,3271,1587,595,297,2676,1324
87621,3083,1486,614,306,2469,1225
85845,2823,1358,597,307,2226,1098
85047,2620,1250,579,310,2041,1009
85518,2419,1114,565,311,1854,892
87636,2270,1061,575,312,1695,850
93277,2172,1014,557,312,1615,833
102539,2248,1062,550,310,1698,887
105812,2366,1025,558,318,1808,814
103384,2379,1033,504,331,1875,824
100079,2133,1045,458,318,1675,826
97745,1903,1191,439,320,1464,930
95151,1874,1373,417,324,1457,1112
92888,1823,1341,408,331,1415,1086
91429,1857,1351,383,328,1474,1131
90076,1831,1258,355,312,1476,1081
89551,1853,1261,343,303,1510,1083
91680,1864,1271,315,262,1549,1095
98916,1977,1430,337,250,1640,1224
101597,2270,1625,392,270,1878,1404
101002,2479,1682,428,278,2051,1448
99709,2559,1678,455,270,2104,1445
96127,2581,1709,438,264,2143,1474
90315,2617,1700,427,268,2190,1466
84807,2599,1641,422,267,2177,1427
80911,2570,1659,426,264,2144,1449
79156,2518,1681,451,263,2067,1483
78501,2392,1767,459,256,1933,1565
78795,2185,1700,442,250,1743,1485
80942,2072,1703,403,267,1669,1460
86311,1982,1678,397,281,1585,1417
95519,1957,1695,401,265,1556,1446
99688,1917,1642,388,240,1529,1419
98821,1751,1492,315,239,1436,1264
96684,1267,1168,232,208,1035,964
94700,950,934,172,148,778,794
92427,892,840,149,115,743,733
90584,968,900,156,131,812,771
89374,1092,1028,158,163,934,874
88301,1059,989,154,168,905,838
87910,989,905,169,178,820,744
89782,855,779,158,169,697,626
95253,948,847,196,195,752,668
95628,1220,1060,264,228,956,843
93720,1544,1309,285,236,1259,1084
91576,1761,1452,317,250,1444,1220
88471,2031,1576,348,267,1683,1326
83704,2143,1620,339,262,1804,1392
78291,2077,1579,334,245,1743,1363
73819,1958,1447,318,197,1640,1279
71362,1826,1272,306,182,1520,1131
69819,1737,1131,330,203,1407,977
69113,1576,1031,336,198,1240,878
69351,1453,942,310,180,1143,818
71458,1401,862,309,169,1092,775
74842,1397,824,293,142,1104,784
77793,1446,906,268,117,1178,905
80668,1328,940,206,91,1122,967
82212,1181,926,141,80,1040,965
82562,1117,932,125,98,992,986
81849,1114,968,124,99,990,1016
80677,1155,981,117,76,1038,1009
79330,1302,1071,136,86,1166,1100
78151,1462,1193,163,102,1299,1229
78031,1561,1298,179,109,1382,1317
80155,1576,1345,202,114,1374,1331
85480,1671,1400,264,136,1407,1364
86001,1771,1407,310,166,1461,1354
84591,1951,1304,313,170,1638,1244
82924,2144,1258,294,174,1850,1166
79903,2397,1232,315,173,2082,1134
76004,2565,1196,319,184,2246,1097
71665,2613,1155,320,206,2293,1019
67638,2675,1066,295,172,2380,944
65052,2703,1020,300,167,2403,881
63480,2684,928,301,137,2383,807
62632,2623,915,309,141,2314,804
62656,2777,1006,321,147,2456,897
63773,2867,1199,323,159,2544,1074
65979,2864,1228,325,164,2539,1127
68635,3086,1447,332,180,2754,1330
72020,3200,1448,309,184,2891,1329
74599,3126,1439,276,195,2850,1301
75845,3011,1456,272,191,2739,1309
76482,3121,1492,270,190,2851,1351
76960,3241,1528,256,181,2985,1408
77087,3360,1657,305,196,3055,1507
76640,3393,1755,377,276,3016,1562
76708,3427,1727,379,271,3048,1546
79236,3518,1719,423,312,3095,1527
84638,3812,1639,473,320,3339,1426
85414,3978,1521,518,339,3460,1310
84253,4051,1356,560,356,3491,1161
82312,4063,1209,546,365,3517,1051
78620,4148,1203,556,353,3592,1070
74220,4116,1217,566,345,3550,1098
69596,4024,1163,557,319,3467,1034
66308,3999,1097,544,321,3455,980
64505,3965,1130,545,323,3420,982
63646,3933,1158,558,329,3375,961
63949,3941,1216,563,284,3378,1039
65817,3930,1211,587,279,3343,1036
71200,3888,1220,583,279,3305,1050
81099,3841,1263,584,266,3257,1129
86141,3863,1314,586,277,3277,1198
86935,3831,1362,554,289,3277,1230
87398,3792,1483,527,292,3265,1343
87556,3692,1595,494,296,3198,1457
87442,3696,1661,491,302,3205,1522
87004,3691,1671,491,323,3200,1510
86770,3622,1664,496,331,3126,1506
86270,3651,1655,501,355,3150,1492
86062,3621,1621,503,369,3118,1448
88027,3479,1536,499,361,2980,1374
94420,3372,1456,521,344,2851,1351
96621,3344,1365,565,344,2779,1290
95519,3390,1217,617,298,2773,1204
93500,3467,1191,660,270,2807,1206
89590,3558,1169,685,258,2873,1196
84184,3545,1012,665,256,2880,1073
78491,3521,980,635,276,2886,1036
74593,3561,982,650,242,2911,1030
72617,3506,1120,626,240,2880,1134
71889,3475,1197,600,237,2875,1210
72108,3439,1223,562,239,2877,1236
74301,3480,1292,576,238,2904,1295
80300,3417,1274,560,219,2857,1284
90212,3264,1377,521,240,2743,1353
95184,3104,1503,489,233,2615,1450
95130,2970,1567,428,230,2542,1514
94476,2911,1600,384,230,2527,1565
93833,3021,1775,382,222,2639,1761
92872,3100,1976,410,269,2690,1904
91721,3132,2047,430,296,2702,1933
90935,3159,2107,431,274,2728,1999
90135,3141,2124,419,243,2722,1997
90255,3175,2150,436,233,2739,1985
93323,3188,2160,466,311,2722,1916
100723,3148,2048,451,318,2697,1796
103089,3200,1813,456,302,2744,1563
102551,3216,1572,451,274,2765,1340
100971,3328,1438,444,263,2884,1200
97311,3428,1402,463,276,2965,1140
91484,3449,1418,492,291,2957,1136
85863,3490,1468,527,319,2963,1165
82135,3385,1524,532,335,2853,1209
80159,3244,1513,538,353,2706,1184
79433,3231,1478,545,356,2686,1159
79788,3122,1399,532,344,2590,1089
82108,3005,1355,532,326,2473,1064
88117,2924,1358,516,308,2408,1095
97799,2931,1390,526,306,2405,1138
101704,2785,1360,514,309,2271,1138
100638,2465,1233,503,319,1962,1020
98354,2159,1177,496,341,1663,941
96188,2244,1373,508,359,1736,1133
93950,2288,1498,505,356,1783,1270
92340,2193,1520,507,353,1686,1281
91044,2078,1525,502,363,1576,1281
90239,1944,1488,471,355,1473,1262
90326,1867,1506,448,349,1419,1286
93548,1867,1418,442,337,1425,1224
101251,1907,1237,457,323,1450,1056
103338,1942,1176,490,324,1452,970
102788,1927,1174,518,337,1409,948
101237,1956,1274,514,359,1442,1024
97569,1945,1289,518,371,1427,1022
91880,1763,1172,506,384,1257,881
86023,1705,1021,481,384,1224,762
81964,1750,913,475,385,1275,710
79610,1813,886,487,395,1326,725
78602,1911,959,498,391,1413,877
78632,1868,990,485,369,1383,959
80522,1743,957,463,345,1280,930
85991,1765,1014,462,339,1303,1004
95165,1738,989,455,336,1283,999
99330,1659,917,469,321,1190,891
98629,1535,834,465,313,1070,767
97191,1550,899,466,300,1084,815
95967,1587,992,483,300,1104,880
94168,1477,929,443,300,1034,795
92895,1426,935,423,310,1003,768
92092,1468,1093,429,331,1039,899
91324,1559,1278,440,359,1119,1046
91266,1672,1435,435,376,1237,1184
93808,1797,1480,449,395,1348,1219
99132,2004,1505,468,402,1536,1260
99721,2303,1480,489,395,1814,1275
98145,2472,1477,497,398,1975,1299
95854,2543,1393,488,401,2055,1239
91889,2603,1254,484,383,2119,1143
85673,2640,1111,474,352,2166,1044
79494,2675,973,454,330,2221,953
75130,2730,959,490,346,2240,937
72314,2684,848,501,355,2183,831
71015,2718,746,513,329,2205,716
70504,2728,650,518,306,2210,648
72090,2756,583,513,295,2243,605
77089,2768,633,513,288,2255,682
85914,2799,810,514,299,2285,833
91030,2740,943,500,308,2240,927
92187,2724,983,475,307,2249,950
92241,2696,905,447,312,2249,898
92329,2727,781,426,308,2301,818
91594,2847,771,419,301,2428,786
90410,2860,856,386,297,2474,816
89781,2777,897,371,284,2406,829
89185,2790,858,372,278,2418,774
89177,2897,704,372,239,2525,663
91418,2983,567,392,203,2591,568
95475,3137,529,433,178,2704,517
95207,3250,501,478,163,2772,500
93121,3247,606,502,147,2745,624
91036,3326,699,518,156,2808,744
87849,3440,747,564,186,2876,853
83472,3520,728,602,206,2918,860
78285,3599,666,578,210,3021,800
73973,3489,702,556,170,2933,774
71582,3469,628,537,158,2932,682
70314,3555,518,536,139,3019,590
70020,3636,437,530,135,3106,535
71000,3602,424,513,107,3089,466
73704,3489,467,498,111,2991,496
77774,3561,502,470,122,3091,500
81676,3574,506,415,142,3159,485
84840,3465,480,341,169,3124,426
87169,3320,482,286,180,3034,365
87805,3249,656,279,186,2970,483
87399,3066,914,271,210,2795,717
86649,2967,1034,285,226,2682,823
85812,2840,1193,313,253,2527,963
85256,2819,1250,340,269,2479,1006
86081,2880,1266,388,286,2492,1006
89412,2911,1281,422,312,2489,1020
96137,2912,1209,482,358,2430,930
98004,2878,993,516,380,2362,754
97735,2966,842,551,380,2415,614
97078,3054,655,572,363,2482,498
95314,3012,522,605,336,2407,383
92241,2999,449,636,308,2363,355
88751,2948,421,655,294,2293,313
86031,2988,529,684,282,2304,356
84396,2888,678,683,256,2205,548
84127,2678,767,666,262,2012,678
84413,2487,820,658,261,1829,730
85785,2427,903,660,265,1767,787
88134,2324,949,633,263,1691,830
91590,2301,1069,617,251,1684,952
94639,2272,1234,597,248,1675,1128
97088,2153,1243,581,257,1572,1164
98067,2115,1280,566,260,1549,1228
97720,2023,1235,559,267,1464,1179
97034,1945,1172,558,276,1387,1085
96533,1972,1304,558,290,1414,1174
95437,1999,1415,561,310,1438,1245
94989,1983,1408,540,324,1443,1225
95865,2036,1390,512,320,1524,1218
99888,2106,1305,513,305,1593,1183
108353,2136,1192,516,300,1620,1111
110591,2167,1150,487,307,1680,1103
110308,2292,1176,474,316,1818,1114
109340,2408,1232,462,322,1946,1138
106074,2565,1264,450,316,2115,1150
101464,2661,1293,430,298,2231,1175
97104,2666,1292,413,269,2253,1203
93893,2643,1272,412,254,2231,1181
92425,2663,1219,422,233,2241,1122
92174,2729,1225,421,234,2308,1083
92879,2687,1172,405,247,2282,1011
95187,2702,1182,404,247,2298,1035
101106,2747,1239,400,240,2347,1094
110241,2732,1295,398,207,2334,1174
114703,2671,1281,362,166,2309,1178
113753,2617,1286,348,188,2269,1209
111677,2388,1242,307,204,2081,1193
109503,2204,1134,286,211,1918,1091
106813,2120,1064,267,226,1853,1060
104523,2057,1032,264,199,1793,1058
103239,2146,1014,278,179,1868,1051
102496,2237,1050,281,114,1956,1062
103019,2175,1187,302,76,1873,1136
106557,2136,1327,336,125,1800,1215
113079,2158,1490,385,167,1773,1330
113913,2144,1619,438,223,1706,1410
112534,2263,1738,460,260,1803,1500
110265,2273,1747,480,269,1793,1505
105803,2211,1681,483,248,1728,1458
99217,2192,1686,486,257,1706,1457
92676,2137,1650,457,236,1680,1448
87902,2080,1675,424,260,1656,1432
85152,1974,1565,348,240,1626,1339
84059,1957,1518,344,255,1613,1280
83824,1926,1426,346,226,1580,1217
85327,1920,1479,347,201,1573,1298
90135,1930,1495,356,188,1574,1334
98809,1857,1508,358,171,1499,1360
104016,1772,1557,339,157,1433,1417
104751,1678,1540,271,142,1407,1416
104897,1609,1504,244,114,1365,1410
105074,1563,1481,214,93,1349,1412
105129,1538,1433,190,74,1348,1407
104753,1552,1405,182,67,1370,1393
104861,1558,1247,174,53,1384,1234
104452,1785,1375,195,56,1590,1332
104555,1953,1377,205,87,1748,1319
107191,1896,1312,222,132,1674,1254
110949,2112,1520,255,188,1857,1415
110383,2432,1639,272,223,2160,1503
108185,2662,1739,299,243,2363,1581
105610,2656,1766,287,234,2369,1606
101034,2649,1720,298,220,2351,1555
94903,2698,1704,292,213,2406,1540
88691,2652,1648,262,201,2390,1496
84026,2608,1621,280,220,2328,1446
81206,2590,1537,278,210,2312,1362
80099,2603,1505,259,211,2344,1340
80069,2432,1319,258,216,2174,1170
81447,2391,1296,276,230,2115,1132
85841,2404,1302,283,227,2121,1128
93456,2544,1358,287,234,2257,1156
99347,2522,1410,299,239,2223,1184
101459,2387,1471,282,218,2105,1261
103280,2229,1372,263,193,1966,1188
104450,2066,1182,233,155,1833,1042
104652,1975,1095,207,129,1768,982
104218,2023,1154,218,130,1805,1030
104150,2077,1131,228,125,1849,1010
103684,2046,1090,212,108,1834,993
103547,2022,1047,188,97,1834,973
105754,1943,976,192,105,1751,914
110891,1973,1028,230,120,1743,977
111267,2127,1141,263,142,1864,1110
109526,2171,1232,291,166,1880,1215
107575,2225,1287,290,176,1935,1282
104317,2231,1287,277,167,1954,1303
99161,2167,1293,276,171,1891,1333
93593,2182,1355,300,178,1882,1396
89209,2204,1363,323,184,1881,1401
86699,2226,1305,327,158,1899,1372
85346,2152,1237,316,141,1836,1318
85066,2214,1221,331,147,1883,1303
85835,2175,1062,328,105,1847,1128
88077,2271,1005,351,127,1920,1072
91114,2385,971,362,91,2023,1000
93759,2449,1012,370,93,2079,999
95875,2512,1052,361,92,2151,1053
97025,2487,1104,359,88,2128,1111
97284,2563,1201,385,139,2178,1212
96071,2541,1267,333,122,2208,1279
92732,2473,1267,298,121,2175,1282
88720,2394,1267,264,104,2130,1277
85599,2324,1286,249,109,2075,1281
84105,2355,1367,251,141,2104,1331
85180,2278,1450,245,171,2033,1380
89746,2216,1633,249,199,1967,1502
91148,2411,1573,282,231,2129,1418
91848,2544,1607,305,262,2239,1418
92348,2529,1588,310,281,2219,1359
91603,2683,1681,324,300,2359,1404
89497,2804,1781,305,281,2499,1509
86582,2807,1784,284,263,2523,1529
83970,2700,1823,266,267,2434,1574
82449,2614,1871,271,309,2343,1590
82093,2623,1829,265,315,2358,1556
82689,2512,1604,274,321,2238,1351
84560,2422,1461,292,325,2130,1236
88320,2589,1703,311,325,2278,1444
92735,2587,1691,336,315,2251,1425
95596,2621,1676,358,292,2263,1417
95850,2571,1678,350,279,2221,1418
94031,2314,1583,299,239,2015,1359
92104,1963,1446,261,223,1702,1239
90178,1820,1368,225,190,1595,1195
88113,1785,1463,176,132,1609,1332
86674,1849,1495,152,132,1697,1372
85777,1788,1444,164,155,1624,1300
86281,1773,1371,188,192,1585,1197
89849,1871,1452,218,231,1653,1249
97723,2167,1423,262,252,1905,1212
99487,2558,1281,290,258,2268,1057
99131,2826,1090,308,243,2518,882
98413,2943,994,316,226,2627,840
96731,2887,935,331,220,2556,834
93473,2917,886,321,209,2596,811
89596,2903,755,333,195,2570,679
86317,2939,715,341,195,2598,588
84377,2890,776,341,200,2549,625
83667,2736,882,337,199,2399,738
83777,2687,976,328,188,2359,850
84596,2683,1018,351,192,2332,909
86977,2728,1044,364,207,2364,934
90433,2697,971,367,199,2330,878
93380,2722,943,387,206,2335,859
95345,2687,939,407,209,2280,847
95518,2410,940,405,212,2005,836
94328,2141,894,377,206,1764,766
91811,2044,860,330,192,1714,680
89288,2123,993,333,191,1790,807
87264,2176,1131,325,178,1851,956
85757,2299,1218,340,180,1959,1047
85563,2382,1246,375,216,2007,1049
88883,2441,1269,377,186,2064,1104
95513,2547,1169,408,159,2139,1039
97326,2750,1097,463,158,2287,981
97009,2887,1087,509,191,2378,962
96214,2929,1027,529,174,2400,921
94366,2867,1030,526,180,2341,921
90694,2900,1233,561,231,2339,1043
86492,2819,1373,559,261,2260,1140
82883,2756,1412,533,249,2223,1198
80744,2763,1508,526,238,2237,1303
79870,2637,1578,510,226,2127,1386
79650,2674,1601,506,222,2168,1410
80494,2662,1519,489,214,2173,1328
82292,2689,1440,476,215,2213,1247
85182,2668,1467,478,255,2190,1237
87827,2605,1343,455,236,2150,1142
89304,2608,1291,433,220,2175,1110
88792,2411,1403,405,242,2006,1214
87173,2290,1558,386,248,1904,1350
85677,2265,1629,373,247,1892,1405
84532,2287,1531,428,271,1859,1297
83619,2309,1404,439,273,1870,1177
82996,2358,1388,438,266,1920,1153
83399,2251,1393,382,246,1869,1180
87106,2144,1158,372,215,1772,1000
94749,2076,992,399,206,1677,874
96872,2212,991,420,188,1792,895
96451,2247,990,416,196,1831,923
95273,2321,1005,417,189,1904,928
91922,2267,1085,415,171,1852,996
87199,2154,1111,401,135,1753,1030
82090,1998,1147,398,135,1600,1064
78505,1935,1158,377,141,1558,1065
76715,1894,1146,371,168,1523,1018
75981,1907,1123,328,162,1579,1000
76528,1874,1125,305,167,1569,1002
78907,1869,1004,306,187,1563,861
84630,1880,872,316,204,1564,711
93447,1826,782,323,209,1503,610
98822,1829,677,346,224,1483,504
99268,1803,573,342,226,1461,384
98654,1682,576,354,229,1328,368
97979,1486,593,359,236,1127,382
96513,1446,576,387,223,1059,390
94868,1437,586,371,236,1066,451
93370,1435,731,341,213,1094,615
92412,1499,935,378,215,1121,789
92864,1579,1020,436,253,1143,849
95942,1546,856,466,267,1080,695
103139,1631,753,466,263,1165,616
104684,1745,706,444,263,1301,641
103920,1834,626,428,276,1406,628
102106,1950,616,411,272,1539,674
98045,1976,625,403,282,1573,635
92043,1928,531,395,283,1533,491
85790,1985,479,382,281,1603,449
80666,2083,428,388,287,1695,457
78172,2085,589,409,304,1676,596
77049,2021,635,418,312,1603,634
77300,2063,658,426,320,1637,622
79107,2097,774,424,322,1673,697
84778,2075,762,415,323,1660,683
94077,2006,733,414,331,1592,653
99550,2033,741,438,341,1595,613
99272,1997,707,451,355,1546,597
97610,1867,655,448,358,1419,555
95869,1740,642,432,345,1308,582
93674,1787,660,443,348,1344,710
91723,1881,714,453,353,1428,819
90644,1855,758,444,347,1411,839
89689,1817,823,462,362,1355,847
89622,1748,759,457,356,1291,781
92848,1762,652,459,361,1303,745
100348,1874,643,486,381,1388,756
102003,1996,686,493,371,1503,810
101587,2023,762,500,334,1523,853
100063,1925,826,483,310,1442,864
96430,1869,760,480,287,1389,805
90288,1825,741,454,249,1371,821
83575,1843,849,441,233,1402,908
79054,1779,797,432,200,1347,826
76037,1722,829,404,180,1318,832
74868,1573,782,372,152,1201,764
74432,1592,862,405,201,1187,802
76214,1465,794,391,189,1074,727
81595,1322,658,343,159,979,605
90922,1307,581,343,165,964,537
96152,1355,623,331,163,1024,559
95643,1426,587,306,158,1120,529
94371,1264,432,267,156,997,413
93451,1079,422,199,131,880,457
92405,857,452,150,92,707,474
91238,788,454,114,76,674,467
90277,929,595,116,93,813,607
89512,1014,716,124,100,890,698
89687,1085,727,158,96,927,684
93062,1273,821,206,122,1067,751
99275,1490,881,273,149,1217,786
100132,1699,826,369,182,1330,690
98681,1950,827,412,199,1538,678
96709,2156,871,446,212,1710,717
92694,2393,1035,496,225,1897,865
86028,2527,1139,533,204,1994,993
79170,2584,1220,508,144,2076,1101
74265,2419,1195,407,114,2012,1100
71229,2305,1188,408,126,1897,1092
69808,2243,1256,413,164,1830,1151
69371,2176,1266,447,202,1729,1145
70733,2028,1191,463,208,1565,1097
75805,1873,1247,473,214,1400,1163
85350,1736,1191,460,196,1276,1116
91045,1718,1214,465,194,1253,1140
91451,1624,1180,466,203,1158,1097
91532,1627,1207,466,224,1161,1126
91569,1619,1171,459,235,1160,1084
91219,1529,1100,435,228,1094,1001
90776,1432,964,407,232,1025,895
90584,1254,853,385,218,869,811
90613,1192,816,387,214,805,737
90813,1102,697,372,227,730,617
94093,1022,533,309,207,713,483
100005,1069,411,274,192,795,394
100692,1319,376,274,183,1045,372
99729,1544,352,258,150,1286,332
97719,1730,343,230,127,1500,294
94068,1856,307,197,108,1659,284
88291,1939,314,171,94,1768,352
81772,2044,447,166,89,1878,491
76601,2009,341,197,104,1812,402
73460,1910,167,254,151,1656,287
72263,1874,225,264,140,1610,307
71857,1921,427,254,124,1667,459
73146,1939,485,258,133,1681,484
78304,1888,533,252,138,1636,534
87281,1986,543,264,145,1722,570
93664,1946,506,272,166,1674,552
95145,1761,549,236,184,1525,562
95984,1518,473,222,232,1296,517
97004,1296,506,222,251,1074,568
97537,1199,660,199,222,1000,701
97447,1152,651,164,185,988,649
97209,1181,729,149,137,1032,650
97229,1420,1020,157,110,1263,916
97511,1514,1126,180,107,1334,1038
100424,1426,931,216,135,1210,845
105238,1396,805,257,182,1139,710
105647,1487,757,294,215,1193,650
103682,1616,721,331,237,1285,568
101832,1783,759,357,257,1426,595
98864,1849,741,345,230,1504,635
94143,1819,734,324,221,1495,664
88267,1832,763,326,225,1506,776
83530,1858,634,333,229,1525,676
80680,1801,559,328,215,1473,572
79136,1671,562,334,218,1337,545
78764,1540,586,323,210,1217,491
79419,1418,628,312,203,1106,510
81912,1345,641,308,182,1037,551
85803,1237,643,290,159,947,540
90058,1175,710,273,170,902,575
93276,1201,781,262,184,939,618
95147,1139,904,245,194,894,715
95549,1020,895,218,171,802,727
95125,964,839,231,170,733,677
93913,923,818,224,158,699,666
92419,918,823,206,128,712,702
91471,908,840,182,105,726,745
91581,957,850,167,102,790,760
95323,1003,735,146,84,857,662
103183,1120,785,150,85,970,715
104987,1259,860,166,86,1093,787
104243,1612,1146,181,91,1431,1066
103124,1859,1297,210,111,1649,1208
100978,2034,1386,214,91,1820,1322
97726,2149,1453,229,135,1920,1349
93078,2100,1531,233,142,1867,1403
88796,1809,1338,247,158,1562,1197
86148,1863,1283,266,166,1597,1151
84792,2014,1233,295,173,1719,1119
84285,1948,1138,276,170,1672,1037
84695,1965,1123,285,160,1680,1043
86215,2040,1094,298,181,1742,1028
88764,2139,999,301,201,1838,961
91905,2194,1030,294,209,1900,984
95265,2242,1063,310,220,1932,1009
98570,2242,1028,314,237,1928,959
100797,2261,1267,339,288,1922,1113
102214,2340,1465,365,295,1975,1290
102865,2387,1679,351,297,2036,1481
102782,2308,1798,325,290,1983,1583
102226,2264,1812,324,316,1940,1557
102453,2186,1776,309,309,1877,1501
105790,2085,1572,298,288,1787,1306
112180,2207,1394,326,282,1881,1146
112726,2499,1452,355,293,2144,1231
111281,2582,1535,361,300,2221,1331
109088,2609,1537,343,302,2266,1336
104737,2599,1604,319,310,2280,1389
98837,2483,1521,297,315,2186,1294
92716,2465,1323,280,326,2185,1089
88273,2440,1006,273,329,2167,797
85737,2377,762,270,322,2107,631
84751,2353,669,265,306,2088,576
84622,2434,568,262,288,2172,484
86642,2487,435,237,278,2250,387
91791,2508,443,225,270,2283,407
99623,2440,366,236,268,2204,318
105635,2483,356,260,253,2223,306
107419,2555,426,281,239,2274,349
108112,2412,462,293,222,2119,357
108559,2159,482,305,225,1854,385
108008,1973,541,323,219,1650,478
107197,2027,838,348,192,1679,809
106246,2082,1029,375,161,1707,1005
105606,2149,1005,396,164,1753,1001
105506,2140,896,441,144,1699,911
108466,2092,746,479,121,1613,779
115146,2154,637,528,95,1626,673
116423,2301,402,593,119,1708,468
115139,2309,313,603,124,1706,392
112986,2270,306,579,119,1691,365
108632,2278,372,571,131,1707,431
102400,2333,579,556,124,1777,608
95489,2298,855,538,121,1760,840
90602,2250,957,512,126,1738,963
87914,2257,956,496,116,1761,961
87047,2210,909,487,144,1723,934
86805,2279,1054,474,164,1805,1086
89142,2309,1121,440,182,1869,1145
94367,2344,1050,393,197,1951,1099
102525,2285,1072,357,193,1928,1142
108631,2317,1100,356,201,1961,1181
109943,2378,1103,370,217,2008,1250
110813,2494,1116,364,221,2130,1300
111289,2644,1117,382,235,2262,1308
110762,2700,1176,387,244,2313,1347
110032,2701,1284,394,256,2307,1446
108833,2711,1314,407,256,2304,1467
107117,2686,1425,434,274,2252,1529
106055,2692,1468,452,278,2240,1560
109542,2622,1409,451,274,2171,1485
118529,2442,1286,458,270,1984,1345
120478,2174,1025,484,257,1690,1054
119447,2180,931,539,225,1641,946
117912,2237,860,569,222,1668,872
114090,2329,882,550,233,1779,907
107740,2343,845,531,252,1812,896
101341,2341,983,516,257,1825,1041
96685,2339,1059,532,237,1807,1122
94683,2288,1150,519,237,1769,1215
94075,2292,1220,485,232,1807,1264
94512,2276,1260,475,232,1801,1254
96885,2312,1255,453,242,1859,1198
103004,2302,1125,426,234,1876,1122
112448,2190,933,388,235,1802,1025
117598,2149,837,385,222,1764,954
116165,2153,855,376,216,1777,980
113028,1890,774,364,194,1526,878
110029,1889,731,368,161,1521,813
107965,1976,551,390,137,1586,668
105681,2148,619,416,125,1732,718
104238,2278,635,413,120,1865,736
102919,2319,614,397,127,1922,703
103365,2285,563,400,140,1885,624
107508,2270,658,389,183,1881,661
116551,2227,605,407,212,1820,543
119185,2344,564,437,228,1907,481
118989,2510,554,451,230,2059,470
117955,2557,489,460,235,2097,423
114651,2673,504,469,232,2204,421
108297,2828,644,482,242,2346,531
102096,2846,861,475,221,2371,768
97629,2760,1048,459,197,2301,1002
95295,2651,1091,428,184,2223,1041
94473,2600,1166,401,179,2199,1097
94814,2616,1266,403,183,2213,1193
97121,2662,1318,394,197,2268,1211
103142,2728,1332,423,202,2305,1232
112927,2643,1304,433,187,2210,1216
118494,2598,1147,430,187,2168,1054
118354,2606,1079,430,196,2176,975
116760,2418,983,436,210,1982,852
114980,2214,1023,424,233,1790,870
112366,2181,1072,400,235,1781,945
110300,2194,964,395,232,1799,856
108908,2124,861,401,236,1723,756
107745,2011,830,397,246,1614,712
108097,1860,736,388,233,1472,616
112676,1683,590,404,256,1279,494
121533,1761,433,409,272,1352,348
124076,1970,317,444,269,1526,283
123618,2176,379,482,279,1694,358
122581,2307,368,490,277,1817,369
119285,2387,337,481,274,1906,406
112986,2443,395,446,262,1997,461
106227,2475,430,417,259,2058,474
101242,2539,487,402,258,2137,499
98641,2500,542,358,259,2142,525
97435,2441,525,327,259,2114,499
97469,2493,436,312,275,2181,417
99209,2461,671,305,273,2156,654
104176,2443,812,301,260,2142,794
113039,2391,814,290,248,2101,819
117939,2260,733,283,234,1977,786
116246,2237,663,273,216,1964,779
113169,2207,707,261,218,1946,885
109938,2200,794,251,189,1949,968
106757,2137,895,218,171,1919,1046
103870,2058,923,181,159,1877,1063
102129,1944,935,174,161,1770,1063
100837,1914,893,165,159,1749,1018
101203,1909,940,156,147,1753,1044
104878,2000,1000,167,119,1833,1053
112582,2074,836,184,99,1890,861
113186,2321,879,209,105,2112,885
111659,2423,1138,226,111,2197,1095
110253,2455,1286,246,135,2209,1192
107497,2458,1280,257,134,2201,1181
102912,2381,1337,265,128,2116,1234
96606,2457,1328,286,131,2171,1219
91232,2478,1335,301,147,2177,1200
88042,2492,1324,310,157,2182,1176
86230,2487,1343,326,162,2161,1206
85489,2488,1284,353,178,2135,1165
86103,2560,1316,388,189,2172,1179
88019,2508,1344,410,174,2098,1235
91547,2549,1263,461,145,2088,1192
95870,2612,1181,484,112,2128,1149
99047,2574,1043,496,56,2078,1051
101783,2530,996,524,85,2006,1019
102998,2447,1135,509,110,1938,1151
103044,2501,1358,504,101,1997,1323
102401,2595,1467,524,127,2071,1419
101543,2667,1402,527,186,2140,1365
100901,2862,1490,532,223,2330,1441
101322,2978,1597,533,276,2445,1519
104512,3153,1611,542,286,2611,1538
109556,3168,1360,507,236,2661,1374
109433,3238,1228,540,188,2698,1227
107440,3379,1247,591,169,2788,1203
105158,3408,1289,609,155,2799,1197
101916,3304,1276,561,165,2743,1132
97217,3381,1453,536,228,2845,1254
91690,3484,1523,517,261,2967,1292
86679,3492,1442,484,302,3008,1196
83796,3463,1543,469,330,2994,1267
82248,3449,1449,485,348,2964,1161
81766,3385,1257,485,338,2900,996
82331,3296,1195,498,334,2798,959
84063,3180,1087,488,348,2692,875
86953,3139,1010,500,349,2639,846
90658,3046,913,498,324,2548,798
94005,2929,810,488,324,2441,724
96098,2859,732,506,326,2353,684
96028,2757,589,504,334,2253,632
95595,2658,468,503,355,2155,620
95401,2645,488,492,362,2153,677
94788,2633,483,496,370,2137,682
94520,2534,458,492,369,2042,646
95394,2406,350,482,342,1924,573
99687,2256,325,490,318,1766,540
107721,2239,400,526,295,1713,537
110212,2330,520,565,268,1765,602
110222,2402,655,582,231,1820,660
109560,2346,649,571,197,1775,637
106351,2278,691,548,165,1730,682
101366,2144,697,537,177,1607,724
95544,2047,714,533,192,1514,736
91079,1966,705,512,201,1454,750
88948,1952,716,481,204,1471,789
88390,2016,802,448,204,1568,895
88981,2020,841,417,205,1603,954
91497,2068,782,394,193,1674,918
97655,2005,694,372,185,1633,789
107198,2051,724,356,185,1695,813
113017,2085,760,339,167,1746,855
113116,2197,902,329,146,1868,936
112494,2295,981,293,144,2002,1011
111070,2435,1054,295,172,2140,1060
108881,2571,1187,288,163,2283,1198
107157,2555,1305,279,153,2276,1283
106019,2539,1408,278,150,2261,1372
105012,2629,1489,260,140,2369,1449
105124,2615,1584,283,141,2332,1506
109039,2586,1643,320,151,2266,1543
117295,2579,1758,361,173,2218,1639
119108,2587,1815,400,198,2187,1676
118427,2512,1826,426,199,2086,1680
116780,2562,1902,457,227,2105,1724
112952,2466,1943,471,255,1995,1748
106268,2421,1884,479,260,1942,1698
99078,2277,1758,495,242,1782,1614
93894,2187,1642,511,237,1676,1495
91152,2141,1531,516,215,1625,1385
89775,2115,1423,523,206,1592,1288
89664,2032,1360,544,214,1488,1209
91612,1989,1380,513,211,1476,1199
97303,1924,1405,498,171,1426,1246
106264,1824,1321,457,150,1367,1197
112039,1762,1251,424,151,1338,1137
112065,1748,1247,408,180,1340,1109
111024,1730,1156,404,205,1326,1012
110132,1825,1169,382,212,1443,1042
108670,1942,1192,385,215,1557,1083
107043,2016,1140,361,243,1655,1050
106111,1935,954,351,236,1584,885
105077,1948,920,359,222,1589,892
105035,1936,855,370,232,1566,874
108033,1906,830,394,243,1512,908
115231,1828,785,394,243,1434,859
116940,1806,840,375,229,1431,912
116343,1821,844,416,237,1405,903
115084,1871,980,427,227,1444,1013
111466,1955,1078,435,204,1520,1083
105157,2077,1066,455,187,1622,1080
98079,2090,1024,455,192,1635,1034
92752,2202,974,516,215,1686,983
90392,2298,994,532,217,1766,1029
89467,2223,939,512,189,1711,963
89879,2207,845,496,203,1711,888
92177,2183,814,519,209,1664,853
98084,2204,744,545,204,1659,788
107820,2112,658,539,213,1573,723
113260,2159,774,557,209,1602,850
112292,2176,846,581,173,1595,905
109859,2344,911,566,161,1778,981
107884,2652,1050,570,168,2082,1138
105698,2829,1118,577,150,2252,1204
103638,2910,1197,591,115,2319,1266
102453,2934,1319,600,119,2334,1355
101482,2985,1376,612,113,2373,1407
101528,2924,1430,606,111,2318,1434
105154,2851,1301,620,101,2231,1326
114211,2721,1228,614,94,2107,1259
116958,2834,1364,625,109,2209,1375
116662,2940,1371,620,97,2320,1386
115738,3108,1495,614,74,2494,1476
112570,3162,1644,583,101,2579,1577
106498,3190,1716,589,107,2601,1628
99442,3137,1758,574,129,2563,1648
94443,3014,1738,565,173,2449,1605
91770,2872,1777,523,187,2349,1616
90632,2803,1816,504,214,2299,1624
90680,2633,1867,486,274,2147,1608
92507,2437,1815,483,306,1954,1519
97746,2238,1699,483,301,1755,1411
107078,2070,1590,474,291,1596,1315
111831,1912,1423,462,285,1450,1154
110238,1850,1326,449,276,1401,1073
107250,1814,1332,420,295,1394,1059
103835,1763,1271,431,293,1332,1004
100298,1676,1189,441,301,1235,923
97781,1646,1071,443,294,1203,833
96102,1633,945,443,281,1190,749
94866,1627,850,445,298,1182,659
94762,1634,800,412,281,1222,637
97711,1594,680,397,268,1197,555
105600,1613,663,386,263,1227,551
107114,1832,723,380,279,1452,635
106502,2073,842,377,306,1696,760
105189,2277,976,384,321,1893,858
101757,2512,1120,382,321,2130,1010
95595,2688,1190,375,317,2313,1105
88440,2820,1285,364,322,2456,1193
82950,2831,1308,341,299,2490,1236
79778,2852,1355,334,292,2518,1251
78296,2925,1433,332,292,2593,1312
78089,2893,1419,335,271,2558,1296
79910,2968,1469,337,244,2631,1352
85179,2952,1468,321,202,2631,1370
94230,3013,1489,318,182,2695,1412
100159,3019,1493,314,188,2705,1431
100065,3067,1564,297,228,2770,1523
99011,3017,1593,268,262,2749,1563
97864,3017,1611,259,278,2758,1572
96492,3075,1607,262,303,2813,1556
94933,3104,1631,271,310,2833,1556
93515,3037,1639,267,305,2770,1546
92301,3014,1683,282,306,2732,1556
91873,2955,1655,304,284,2651,1526
94685,2982,1653,370,252,2612,1524
100875,3049,1753,432,229,2617,1605
100786,3167,1845,487,247,2680,1666
98698,3262,1793,523,267,2739,1597
96383,3340,1743,550,288,2790,1527
93037,3382,1760,567,292,2815,1524
87987,3209,1745,569,290,2640,1532
81675,2988,1675,535,276,2453,1483
76046,2940,1667,503,266,2437,1485
72669,2917,1651,510,265,2407,1469
70681,2835,1624,529,270,2306,1458
69735,2771,1594,532,271,2239,1441
70101,2671,1649,534,270,2137,1523
71701,2637,1722,560,273,2077,1603
75038,2747,1726,535,253,2212,1588
79197,2811,1695,532,243,2279,1545
82730,2818,1694,513,236,2305,1534
84945,2815,1730,479,242,2336,1576
85495,2772,1790,443,251,2329,1627
84972,2739,1791,430,274,2309,1607
83973,2638,1748,376,251,2262,1580
82765,2596,1659,371,256,2225,1512
81864,2576,1548,354,254,2222,1393
81617,2548,1377,359,261,2189,1195
84467,2650,1159,395,271,2255,991
90532,2846,1059,466,272,2380,994
91394,2952,988,439,248,2513,969
90097,3048,800,435,234,2613,843
88722,3057,743,444,210,2613,802
86303,3084,920,476,207,2608,953
82294,3064,1113,487,189,2577,1090
76850,2961,1159,508,204,2453,1126
71901,2789,1093,515,210,2274,1126
68460,2759,1130,537,211,2222,1163
66407,2737,1264,601,204,2136,1238
64946,2638,1248,603,220,2035,1206
64836,2547,1169,600,192,1947,1141
65751,2416,1149,601,166,1815,1126
67913,2274,1121,579,147,1695,1091
71122,2256,1000,572,135,1684,957
74592,2232,941,575,133,1657,935
77712,2168,887,578,164,1590,862
79094,2047,746,628,215,1419,696
79897,2011,655,650,217,1361,642
80158,2061,482,655,206,1406,512
80067,2085,473,648,240,1437,532
79844,2028,590,615,246,1413,655
80047,2007,717,590,241,1417,767
83143,2013,701,545,229,1468,726
89385,2139,605,502,238,1637,625
90941,2346,546,483,267,1863,571
90143,2550,474,487,291,2063,536
89014,2595,470,500,276,2095,587
86357,2580,413,478,263,2102,517
81974,2680,372,468,261,2212,417
76534,2688,401,459,266,2229,488
71644,2670,495,456,256,2214,595
68648,2659,500,450,233,2209,617
67224,2576,583,445,195,2131,668
66906,2427,627,432,167,1995,685
68429,2424,680,416,165,2008,663
72443,2516,671,429,150,2087,601
79189,2568,621,458,150,2110,505
85740,2666,717,461,161,2205,574
89363,2752,882,471,166,2281,743
91957,2867,1129,496,183,2371,1005
93716,2775,1256,435,198,2340,1140
94104,2750,1338,395,203,2355,1227
93606,2522,1304,392,222,2130,1168
93174,2416,1366,403,249,2013,1206
92618,2362,1311,401,238,1961,1197
92491,2423,1380,430,244,1993,1289
94893,2489,1432,477,207,2012,1366
100588,2540,1420,526,181,2014,1367
102056,2713,1366,569,117,2144,1325
101379,2860,1459,596,78,2264,1428
100186,2894,1379,598,59,2296,1375
97839,2894,1336,560,76,2334,1305
93724,2814,1357,539,144,2275,1308
87860,2783,1398,521,202,2262,1329
82903,2754,1437,520,253,2234,1311
79786,2620,1316,488,255,2132,1173
78490,2504,1119,420,227,2084,1106
78424,2245,937,368,242,1877,972
80228,2181,1053,367,237,1814,1049
83979,1977,921,391,245,1586,817
89718,1772,725,400,248,1372,579
94980,1586,532,445,290,1141,343
97844,1563,639,497,316,1066,451
99116,1529,683,519,302,1010,516
99116,1513,477,561,260,952,351
97880,1535,419,592,187,943,317
96221,1423,196,614,139,809,84
94697,1304,254,563,117,741,209
93867,1309,494,508,148,801,426
93732,1471,735,498,193,973,641
96734,1595,930,505,236,1090,784
103668,1685,994,520,228,1165,832
104014,1742,997,507,204,1235,888
102583,1790,996,508,222,1282,865
102129,1911,1050,493,245,1418,891
101478,1966,1154,472,262,1494,941
99644,1948,1201,469,288,1479,952
96349,1883,1071,447,272,1436,824
92855,2062,1164,446,275,1616,901
90200,2140,1076,438,249,1702,836
88886,2048,632,422,197,1626,443
88650,1922,399,378,203,1544,244
89464,2048,432,349,194,1699,282
91480,1986,318,331,220,1655,180
94658,1943,485,325,225,1618,315
97557,1852,550,297,232,1555,371
99023,1974,888,297,291,1677,641
98673,2013,987,257,277,1756,748
97189,1990,1240,247,303,1743,1006
95233,2024,1397,231,305,1793,1172
92764,2063,1535,230,333,1833,1279
90186,1977,1408,216,320,1761,1187
88402,2057,1374,220,314,1837,1200
87964,2026,1375,220,267,1806,1281
90289,2015,1358,247,245,1768,1312
96329,2190,1361,276,238,1914,1304
97734,2551,1287,313,223,2238,1221
98024,2894,1248,344,190,2550,1204
98127,3124,1163,380,168,2744,1083
97024,3358,1084,395,206,2963,965
94231,3479,1080,401,217,3078,962
90176,3590,1044,400,221,3190,901
86891,3660,1048,381,227,3279,883
85051,3657,1031,368,211,3289,864
84339,3780,975,393,218,3387,788
84740,3927,898,412,236,3515,692
86344,3999,795,431,248,3568,597
90129,3989,789,444,228,3545,671
95731,3918,918,454,220,3464,833
100969,3728,875,417,209,3311,837
103206,3752,883,423,213,3329,845
104448,3819,1086,442,219,3377,1010
104256,3634,1085,459,220,3175,988
102568,3465,1132,460,244,3005,1010
100229,3342,1140,443,234,2899,1032
97923,3232,1202,442,222,2790,1095
95865,3191,1312,459,209,2732,1200
95219,3155,1421,485,224,2670,1293
97913,3133,1462,487,228,2646,1358
106255,3147,1419,505,216,2642,1345
108779,3221,1257,536,190,2685,1204
108093,3409,1241,585,174,2824,1179
106884,3501,1264,624,194,2877,1204
104047,3522,1320,610,238,2912,1207
99492,3456,1403,593,262,2863,1247
94093,3318,1441,570,282,2748,1277
89583,3256,1409,554,288,2702,1208
87240,3331,1454,545,300,2786,1192
86239,3363,1416,521,292,2842,1131
86225,3228,1253,525,290,2703,976
87791,3168,1209,518,267,2650,965
92021,3242,1408,529,248,2713,1174
98033,3246,1523,541,261,2705,1297
102946,3092,1574,533,267,2559,1368
103955,3064,1733,532,281,2532,1535
102695,2920,1714,495,290,2425,1537
100817,2989,1770,484,285,2505,1624
98316,3024,1760,487,260,2537,1653
95741,3056,1803,478,254,2578,1683
93448,2978,1716,403,206,2575,1633
91595,2926,1581,354,185,2572,1542
91035,2950,1573,383,179,2567,1494
93250,2749,1431,389,192,2360,1307
100875,2681,1246,433,170,2248,1139
103237,2711,1213,447,113,2264,1145
102698,2832,1269,465,111,2367,1200
101702,2809,1273,532,143,2277,1161
99554,2853,1337,558,146,2295,1219
95610,2869,1361,564,155,2305,1262
90592,2847,1470,563,158,2284,1389
86294,2870,1492,543,175,2327,1412
83883,2820,1475,543,185,2277,1364
82744,2839,1492,551,194,2288,1354
82515,2851,1449,528,184,2323,1336
83223,2809,1447,528,208,2281,1337
85258,2754,1505,511,240,2243,1379
88199,2798,1512,500,259,2298,1331
91312,2799,1560,512,262,2287,1374
92706,2766,1595,488,236,2278,1413
92653,2638,1484,442,206,2196,1339
91025,2392,1354,357,176,2035,1262
88438,2322,1429,284,184,2038,1369
85538,2287,1539,250,187,2037,1496
83029,2314,1608,234,175,2080,1561
81088,2334,1666,234,181,2100,1590
80796,2268,1641,241,199,2027,1531
83480,2200,1705,257,242,1943,1525
91301,2409,1883,277,283,2132,1669
93511,2481,1950,338,326,2143,1684
93104,2558,1948,360,335,2198,1697
92074,2449,1808,359,310,2090,1596
89802,2452,1812,371,270,2081,1626
86004,2539,1909,372,245,2167,1690
81255,2538,1923,389,253,2149,1673
77152,2693,2108,376,273,2317,1847
74444,2608,2000,333,244,2275,1768
72678,2580,1906,329,231,2251,1685
71924,2566,1788,327,217,2239,1582
72075,2605,1796,340,235,2265,1574
73485,2673,1802,328,218,2345,1592
75522,2690,1853,314,198,2376,1659
78598,2795,1783,331,208,2464,1582
81568,2983,1824,331,222,2652,1612
84540,3067,1854,352,264,2715,1601
86861,3089,1931,342,283,2747,1669
88396,3072,1898,305,253,2767,1673
89344,3206,1935,295,250,2911,1722
88848,3213,1923,300,262,2913,1706
87884,3207,1891,325,268,2882,1693
87569,3216,1851,337,257,2879,1659
89746,3138,1797,378,255,2760,1607
95340,3056,1751,397,269,2659,1541
97017,3050,1730,383,236,2667,1547
95935,2959,1779,403,236,2556,1590
94657,2898,1872,440,250,2458,1661
91864,2780,1925,452,282,2328,1683
88239,2662,1996,428,266,2234,1769
83571,2470,1958,404,247,2066,1747
79915,2402,2001,412,268,1990,1759
77749,2394,1965,416,275,1978,1719
76975,2292,1923,419,269,1873,1678
77370,2180,1907,412,261,1768,1670
79193,2183,1912,430,232,1753,1699
83567,2100,1860,427,224,1673,1654
89976,1907,1802,403,217,1504,1605
95748,1729,1643,401,251,1328,1425
98235,1633,1431,397,262,1236,1203
99624,1487,1313,375,253,1112,1097
100808,1346,1271,405,266,941,1030
100875,1223,1025,404,247,819,804
100717,1201,875,407,239,794,657
100220,1442,971,447,228,995,757
99693,1601,1080,463,235,1138,857
99896,1605,1049,436,242,1169,824
102509,1684,1064,417,250,1267,836
109439,1863,1288,385,259,1478,1046
110903,2149,1600,372,270,1777,1344
109829,2469,1839,367,287,2102,1575
108122,2698,2054,375,279,2323,1802
104914,2696,2075,363,245,2333,1860
99774,2736,2074,355,221,2381,1890
93845,2746,2033,340,197,2406,1871
89325,2751,1988,368,208,2383,1824
86672,2800,1861,390,207,2410,1696
85447,2759,1712,340,166,2419,1612
85371,2767,1595,331,142,2436,1539
86748,2839,1460,338,127,2501,1446
90811,2828,1395,341,136,2487,1381
96629,2772,1441,376,151,2396,1411
101579,2826,1519,423,130,2403,1459
103278,2753,1562,458,140,2295,1473
103778,2693,1493,465,166,2228,1403
103784,2674,1374,466,184,2208,1264
102913,2757,1348,457,195,2300,1217
101253,2987,1438,516,222,2471,1304
100132,3030,1369,541,217,2489,1290
98741,3049,1331,541,231,2508,1289
98208,2930,1278,538,264,2392,1256
100526,2854,1275,526,255,2328,1276
108411,2633,1139,507,245,2126,1164
109742,2624,1107,521,225,2103,1116
107030,1765,1162,418,292,1347,981
104018,1308,1160,313,316,995,925
100683,1287,1109,318,333,969,870
97503,1269,1052,317,330,952,830
94448,1312,1105,312,325,1000,926
